State,Code,County,DEM,OTH,REP,Total Votes,Winner,Vote Margin,Win Margin,Population,RUCC Code
Arizona,AZ,Apache County,23293,437,11442,35172,DEM,11851,33.69441601,71518,6
Arizona,AZ,Cochise County,23732,1153,35557,60442,REP,11825,19.56421032,131346,3
Arizona,AZ,Coconino County,44698,1522,27052,73272,DEM,17646,24.08286931,134421,3
Arizona,AZ,Gila County,8943,342,18377,27662,REP,9434,34.10454776,53597,4
Arizona,AZ,Graham County,4034,212,10749,14995,REP,6715,44.78159386,37220,7
Arizona,AZ,Greenlee County,1182,70,2433,3685,REP,1251,33.94843962,8437,7
Arizona,AZ,La Paz County,2236,93,5129,7458,REP,2893,38.79056047,20489,6
Arizona,AZ,Maricopa County,1040774,31705,995665,2068144,DEM,45109,2.181134389,3817117,1
Arizona,AZ,Mohave County,24831,1302,78535,104668,REP,53704,51.30890052,200186,3
Arizona,AZ,Navajo County,23383,727,27657,51767,REP,4274,8.256225008,107449,4
Arizona,AZ,Pima County,304981,7658,207758,520397,DEM,97223,18.68246742,980263,2
Arizona,AZ,Pinal County,75106,3342,107077,185525,REP,31971,17.23271796,375770,1
Arizona,AZ,Santa Cruz County,13138,224,6194,19556,DEM,6944,35.5082839,47420,4
Arizona,AZ,Yavapai County,49602,2092,91527,143221,REP,41925,29.27294182,211033,3
Arizona,AZ,Yuma County,32210,1137,36534,69881,REP,4324,6.187661882,195751,3
Florida,FL,Alachua County,89704,1928,50972,142604,DEM,38732,27.16052846,247336,2
Florida,FL,Baker County,2037,111,11911,14059,REP,9874,70.23259122,27115,1
Florida,FL,Bay County,25614,1313,66097,93024,REP,40483,43.51887685,168852,3
Florida,FL,Bradford County,3160,138,10334,13632,REP,7174,52.62617371,28520,6
Florida,FL,Brevard County,148549,4332,207883,360764,REP,59334,16.44676298,543376,2
Florida,FL,Broward County,618752,5511,333409,957672,DEM,285343,29.79548321,1748066,1
Florida,FL,Calhoun County,1209,43,5274,6526,REP,4065,62.28930432,14625,6
Florida,FL,Charlotte County,42273,824,73243,116340,REP,30970,26.62025099,159978,3
Florida,FL,Citrus County,27092,764,65352,93208,REP,38260,41.04797871,141236,3
Florida,FL,Clay County,38317,1608,84480,124405,REP,46163,37.10702946,190865,1
Florida,FL,Collier County,77621,1247,128950,207818,REP,51329,24.69901548,321520,2
Florida,FL,Columbia County,8914,292,23836,33042,REP,14922,45.16070456,67531,4
Florida,FL,DeSoto County,4259,87,8313,12659,REP,4054,32.0246465,34862,6
Florida,FL,Dixie County,1365,43,6759,8167,REP,5394,66.04628383,16422,6
Florida,FL,Duval County,252556,6502,233762,492820,DEM,18794,3.813562761,864263,1
Florida,FL,Escambia County,70929,2769,96674,170372,REP,25745,15.11105111,297619,2
Florida,FL,Flagler County,28161,512,43043,71716,REP,14882,20.75129678,95696,2
Florida,FL,Franklin County,2120,54,4675,6849,REP,2555,37.30471602,11549,6
Florida,FL,Gadsden County,16153,144,7465,23762,DEM,8688,36.56257891,46389,2
Florida,FL,Gilchrist County,1700,90,7895,9685,REP,6195,63.96489417,16939,2
Florida,FL,Glades County,1385,26,3782,5193,REP,2397,46.15829001,12884,6
Florida,FL,Gulf County,1985,65,6113,8163,REP,4128,50.56964351,15863,3
Florida,FL,Hamilton County,1963,52,3815,5830,REP,1852,31.76672384,14799,6
Florida,FL,Hardee County,2298,65,6122,8485,REP,3824,45.06776665,27731,6
Florida,FL,Hendry County,4929,105,7906,12940,REP,2977,23.00618238,39140,4
Florida,FL,Hernando County,37519,991,70412,108922,REP,32893,30.19867428,172778,1
Florida,FL,Highlands County,16938,359,34873,52170,REP,17935,34.37799502,98786,3
Florida,FL,Hillsborough County,376367,8298,327398,712063,DEM,48969,6.877060035,1229226,1
Florida,FL,Holmes County,924,64,8080,9068,REP,7156,78.91486546,19927,6
Florida,FL,Indian River County,37844,768,58872,97484,REP,21028,21.5707193,138028,3
Florida,FL,Jackson County,6766,165,15488,22419,REP,8722,38.90450065,49746,6
Florida,FL,Jefferson County,3897,75,4479,8451,REP,582,6.886758963,14761,2
Florida,FL,Lafayette County,510,20,3128,3658,REP,2618,71.56916348,8870,9
Florida,FL,Lake County,83505,1950,125859,211314,REP,42354,20.04315852,297052,1
Florida,FL,Lee County,157695,2957,233247,393899,REP,75552,19.18055136,618754,2
Florida,FL,Leon County,103517,1959,57453,162929,DEM,46064,28.27243769,275487,2
Florida,FL,Levy County,6205,191,16749,23145,REP,10544,45.55627565,40801,6
Florida,FL,Liberty County,694,21,2846,3561,REP,2152,60.43246279,8365,8
Florida,FL,Madison County,3747,57,5576,9380,REP,1829,19.4989339,19224,6
Florida,FL,Manatee County,90166,1805,124987,216958,REP,34821,16.04965016,322833,2
Florida,FL,Marion County,74858,1692,127826,204376,REP,52968,25.91693741,331298,2
Florida,FL,Martin County,36893,665,61168,98726,REP,24275,24.58825436,146318,2
Florida,FL,Miami-Dade County,617864,6119,532833,1156816,DEM,85031,7.350434296,2496435,1
Florida,FL,Monroe County,21881,455,25693,48029,REP,3812,7.936871473,73090,4
Florida,FL,Nassau County,15564,681,42566,58811,REP,27002,45.91317951,73314,1
Florida,FL,Okaloosa County,34248,2327,79798,116373,REP,45550,39.14138159,180822,3
Florida,FL,Okeechobee County,4390,94,11470,15954,REP,7080,44.37758556,39996,4
Florida,FL,Orange County,395014,6991,245398,647403,DEM,149616,23.11018021,1145956,1
Florida,FL,Osceola County,97297,1659,73480,172436,DEM,23817,13.812081,268685,1
Florida,FL,Palm Beach County,433572,4875,334711,773158,DEM,98861,12.78664904,1320134,1
Florida,FL,Pasco County,119073,3276,179621,301970,REP,60548,20.05099844,464697,1
Florida,FL,Pinellas County,277450,6056,276209,559715,DEM,1241,0.221719982,916542,1
Florida,FL,Polk County,145049,3621,194586,343256,REP,49537,14.43150302,602095,2
Florida,FL,Putnam County,10527,332,25514,36373,REP,14987,41.20364006,74364,4
Florida,FL,Santa Rosa County,27612,1931,77385,106928,REP,49773,46.54814455,151372,2
Florida,FL,Sarasota County,120110,2095,148370,270575,REP,28260,10.44442391,379448,2
Florida,FL,Seminole County,132528,3046,125241,260815,DEM,7287,2.793934398,422718,1
Florida,FL,St. Johns County,63850,1826,110946,176622,REP,47096,26.66485489,190039,1
Florida,FL,St. Lucie County,84137,1201,86831,172169,REP,2694,1.56474162,277789,2
Florida,FL,Sumter County,29341,383,62761,92485,REP,33420,36.13558956,93420,3
Florida,FL,Suwannee County,4485,162,16410,21057,REP,11925,56.63199886,41551,6
Florida,FL,Taylor County,2299,77,7751,10127,REP,5452,53.83627925,22570,6
Florida,FL,Union County,1053,59,5133,6245,REP,4080,65.33226581,15535,6
Florida,FL,Volusia County,130575,3043,173821,307439,REP,43246,14.06653027,494593,2
Florida,FL,Wakulla County,5351,179,12874,18404,REP,7523,40.87698326,30776,2
Florida,FL,Walton County,10338,426,32947,43711,REP,22609,51.72382238,55043,3
Florida,FL,Washington County,2347,104,9876,12327,REP,7529,61.07730997,24896,6
Georgia,GA,Appling County,1779,36,6526,8341,REP,4747,56.91164129,18236,7
Georgia,GA,Atkinson County,825,30,2300,3155,REP,1475,46.75118859,8375,9
Georgia,GA,Bacon County,625,25,4018,4668,REP,3393,72.68637532,11096,7
Georgia,GA,Baker County,652,6,897,1555,REP,245,15.75562701,3451,3
Georgia,GA,Baldwin County,9140,208,8903,18251,DEM,237,1.298558983,45720,4
Georgia,GA,Banks County,932,74,7795,8801,REP,6863,77.97977503,18395,8
Georgia,GA,Barrow County,10453,760,26804,38017,REP,16351,43.00970618,69367,1
Georgia,GA,Bartow County,12092,701,37674,50467,REP,25582,50.69055026,100157,1
Georgia,GA,Ben Hill County,2392,58,4110,6560,REP,1718,26.18902439,17634,7
Georgia,GA,Berrien County,1269,55,6419,7743,REP,5150,66.51168798,19286,6
Georgia,GA,Bibb County,43468,749,26585,70802,DEM,16883,23.8453716,155547,3
Georgia,GA,Bleckley County,1311,67,4328,5706,REP,3017,52.87416754,13063,6
Georgia,GA,Brantley County,699,56,6991,7746,REP,6292,81.22902143,18411,3
Georgia,GA,Brooks County,2790,50,4260,7100,REP,1470,20.70422535,16243,3
Georgia,GA,Bryan County,6739,357,14244,21340,REP,7505,35.16869728,30233,2
Georgia,GA,Bulloch County,11243,455,18386,30084,REP,7143,23.74351815,70217,4
Georgia,GA,Burke County,5209,75,5400,10684,REP,191,1.787719955,23316,2
Georgia,GA,Butts County,3272,112,8405,11789,REP,5133,43.54058868,23655,1
Georgia,GA,Calhoun County,1260,11,923,2194,DEM,337,15.36007293,6694,8
Georgia,GA,Camden County,7967,470,15251,23688,REP,7284,30.74974671,50513,4
Georgia,GA,Candler County,1269,29,3134,4432,REP,1865,42.08032491,10998,7
Georgia,GA,Carroll County,16238,760,37476,54474,REP,21238,38.98740684,110527,1
Georgia,GA,Catoosa County,6932,593,25167,32692,REP,18235,55.77817203,63942,2
Georgia,GA,Charlton County,1103,44,3419,4566,REP,2316,50.72273325,12171,6
Georgia,GA,Chatham County,78369,1932,53288,133589,DEM,25081,18.77474942,265128,2
Georgia,GA,Chattahoochee County,667,43,880,1590,REP,213,13.39622642,11267,2
Georgia,GA,Chattooga County,1854,132,8064,10050,REP,6210,61.79104478,26015,6
Georgia,GA,Cherokee County,42794,2449,99587,144830,REP,56793,39.21356073,214346,1
Georgia,GA,Clarke County,36048,839,14446,51333,DEM,21602,42.08209144,116714,3
Georgia,GA,Clay County,790,7,637,1434,DEM,153,10.66945607,3183,9
Georgia,GA,Clayton County,95476,1055,15813,112344,DEM,79663,70.90988393,259424,1
Georgia,GA,Clinch County,747,12,2105,2864,REP,1358,47.41620112,6798,6
Georgia,GA,Cobb County,221846,6441,165459,393746,DEM,56387,14.32065342,688078,1
Georgia,GA,Coffee County,4511,125,10578,15214,REP,6067,39.87774418,42356,7
Georgia,GA,Colquitt County,4187,119,11777,16083,REP,7590,47.19268793,45498,6
Georgia,GA,Columbia County,29236,1330,50013,80579,REP,20777,25.78463371,124053,2
Georgia,GA,Cook County,2059,76,4900,7035,REP,2841,40.38379531,17212,6
Georgia,GA,Coweta County,24210,1088,51501,76799,REP,27291,35.53561895,127317,1
Georgia,GA,Crawford County,1615,59,4428,6102,REP,2813,46.09963946,12630,3
Georgia,GA,Crisp County,2986,79,4987,8052,REP,2001,24.8509687,23439,6
Georgia,GA,Dade County,1261,107,6066,7434,REP,4805,64.6354587,16633,2
Georgia,GA,Dawson County,2486,197,13398,16081,REP,10912,67.85647659,22330,1
Georgia,GA,DeKalb County,308140,4202,58369,370711,DEM,249771,67.37620411,691893,1
Georgia,GA,Decatur County,4780,89,6758,11627,REP,1978,17.01212695,27842,6
Georgia,GA,Dodge County,2171,56,5843,8070,REP,3672,45.50185874,21796,6
Georgia,GA,Dooly County,1911,35,2159,4105,REP,248,6.041412911,14918,6
Georgia,GA,Dougherty County,24579,280,10449,35308,DEM,14130,40.01925909,94565,3
Georgia,GA,Douglas County,42653,830,25323,68806,DEM,17330,25.18675697,132403,1
Georgia,GA,Early County,2437,28,2722,5187,REP,285,5.494505495,11008,6
Georgia,GA,Echols County,167,18,1256,1441,REP,1089,75.57251908,4034,3
Georgia,GA,Effingham County,7720,547,23357,31624,REP,15637,49.44662282,52250,2
Georgia,GA,Elbert County,2879,66,6226,9171,REP,3347,36.49547487,20166,6
Georgia,GA,Emanuel County,2884,66,6551,9501,REP,3667,38.59593727,22598,7
Georgia,GA,Evans County,1324,35,2888,4247,REP,1564,36.82599482,11000,6
Georgia,GA,Fannin County,2571,110,12169,14850,REP,9598,64.63299663,23682,8
Georgia,GA,Fayette County,31937,933,36375,69245,REP,4438,6.409127013,106567,1
Georgia,GA,Floyd County,10972,496,27120,38588,REP,16148,41.84720639,96317,3
Georgia,GA,Forsyth County,42203,1980,85122,129305,REP,42919,33.19206527,175511,1
Georgia,GA,Franklin County,1593,124,9069,10786,REP,7476,69.3120712,22084,8
Georgia,GA,Fulton County,381144,6275,137240,524659,DEM,243904,46.48809989,920581,1
Georgia,GA,Gilmer County,2932,164,13429,16525,REP,10497,63.52193646,28292,6
Georgia,GA,Glascock County,155,8,1403,1566,REP,1248,79.69348659,3082,9
Georgia,GA,Glynn County,15879,489,25616,41984,REP,9737,23.19216845,79626,3
Georgia,GA,Gordon County,4384,244,19405,24033,REP,15021,62.50156035,55186,4
Georgia,GA,Grady County,3619,54,7034,10707,REP,3415,31.89502195,25011,6
Georgia,GA,Greene County,4088,91,7068,11247,REP,2980,26.49595448,15994,6
Georgia,GA,Gwinnett County,241827,5625,166413,413865,DEM,75414,18.22188395,805321,1
Georgia,GA,Habersham County,3563,232,16637,20432,REP,13074,63.98786218,43041,6
Georgia,GA,Hall County,25031,1322,64170,90523,REP,39139,43.23652552,179684,3
Georgia,GA,Hancock County,2985,21,1159,4165,DEM,1826,43.84153661,9429,7
Georgia,GA,Haralson County,1792,149,12331,14272,REP,10539,73.84389013,28780,1
Georgia,GA,Harris County,5457,215,14319,19991,REP,8862,44.32994848,32024,2
Georgia,GA,Hart County,3157,106,9464,12727,REP,6307,49.55606192,25213,6
Georgia,GA,Heard County,824,57,4516,5397,REP,3692,68.40837502,11834,1
Georgia,GA,Henry County,73276,1279,48187,122742,DEM,25089,20.44043604,203922,1
Georgia,GA,Houston County,32232,1057,41534,74823,REP,9302,12.4320062,139900,3
Georgia,GA,Irwin County,1008,26,3134,4168,REP,2126,51.00767754,9538,7
Georgia,GA,Jackson County,7642,531,29497,37670,REP,21855,58.01698965,60485,4
Georgia,GA,Jasper County,1761,61,5822,7644,REP,4061,53.12663527,13900,1
Georgia,GA,Jeff Davis County,1028,48,4695,5771,REP,3667,63.54184717,15068,7
Georgia,GA,Jefferson County,4061,44,3537,7642,DEM,524,6.856843758,16930,6
Georgia,GA,Jenkins County,1266,28,2161,3455,REP,895,25.90448625,8340,6
Georgia,GA,Johnson County,1222,28,2850,4100,REP,1628,39.70731707,9980,7
Georgia,GA,Jones County,4888,113,9965,14966,REP,5077,33.92356007,28669,3
Georgia,GA,Lamar County,2615,94,6330,9039,REP,3715,41.09967917,18317,1
Georgia,GA,Lanier County,1019,48,2509,3576,REP,1490,41.66666667,10078,3
Georgia,GA,Laurens County,8073,163,14493,22729,REP,6420,28.24585332,48434,5
Georgia,GA,Lee County,4558,149,12007,16714,REP,7449,44.5674285,28298,3
Georgia,GA,Liberty County,13099,331,7959,21389,DEM,5140,24.03104399,63453,3
Georgia,GA,Lincoln County,1435,36,3179,4650,REP,1744,37.50537634,7996,2
Georgia,GA,Long County,2033,95,3528,5656,REP,1495,26.4321075,14464,3
Georgia,GA,Lowndes County,20117,547,25691,46355,REP,5574,12.02459282,109233,3
Georgia,GA,Lumpkin County,3126,242,12163,15531,REP,9037,58.1868521,29966,6
Georgia,GA,Macon County,2857,22,1783,4662,DEM,1074,23.03732304,14740,6
Georgia,GA,Madison County,3411,200,11326,14937,REP,7915,52.9892214,28120,3
Georgia,GA,Marion County,1311,38,2275,3624,REP,964,26.6004415,8742,2
Georgia,GA,McDuffie County,4168,118,6169,10455,REP,2001,19.13916786,21875,2
Georgia,GA,McIntosh County,2612,68,4016,6696,REP,1404,20.96774194,14333,3
Georgia,GA,Meriwether County,4287,66,6524,10877,REP,2237,20.56633263,21992,1
Georgia,GA,Miller County,749,20,2066,2835,REP,1317,46.45502646,6125,8
Georgia,GA,Mitchell County,3995,33,4935,8963,REP,940,10.48755997,23498,6
Georgia,GA,Monroe County,4384,148,11060,15592,REP,6676,42.81682914,26424,3
Georgia,GA,Montgomery County,979,27,2960,3966,REP,1981,49.94957136,9123,9
Georgia,GA,Morgan County,3355,122,8230,11707,REP,4875,41.6417528,17868,1
Georgia,GA,Murray County,2302,144,12943,15389,REP,10641,69.14679316,39628,3
Georgia,GA,Muscogee County,49529,965,30049,80543,DEM,19480,24.18583862,189885,2
Georgia,GA,Newton County,29794,576,23869,54239,DEM,5925,10.92387397,99958,1
Georgia,GA,Oconee County,8162,411,16595,25168,REP,8433,33.50683408,32808,3
Georgia,GA,Oglethorpe County,2436,102,5593,8131,REP,3157,38.82671258,14899,3
Georgia,GA,Paulding County,29704,1156,54525,85385,REP,24821,29.0695087,142324,1
Georgia,GA,Peach County,5920,123,6502,12545,REP,582,4.639298525,27695,3
Georgia,GA,Pickens County,2808,233,14075,17116,REP,11267,65.8272961,29431,1
Georgia,GA,Pierce County,1100,49,7899,9048,REP,6799,75.14367816,18758,6
Georgia,GA,Pike County,1505,88,9127,10720,REP,7622,71.10074627,17869,1
Georgia,GA,Polk County,3658,152,13589,17399,REP,9931,57.07799299,41475,4
Georgia,GA,Pulaski County,1217,37,2805,4059,REP,1588,39.12293668,12010,3
Georgia,GA,Putnam County,3448,116,8291,11855,REP,4843,40.8519612,21218,6
Georgia,GA,Quitman County,497,5,604,1106,REP,107,9.674502712,2513,9
Georgia,GA,Rabun County,1984,110,7474,9568,REP,5490,57.37876254,16276,7
Georgia,GA,Randolph County,1671,12,1391,3074,DEM,280,9.108653221,7719,6
Georgia,GA,Richmond County,59124,1111,26781,87016,DEM,32343,37.16902639,200549,2
Georgia,GA,Rockdale County,31244,430,13012,44686,DEM,18232,40.80025064,85215,1
Georgia,GA,Schley County,462,13,1800,2275,REP,1338,58.81318681,5010,8
Georgia,GA,Screven County,2661,51,3916,6628,REP,1255,18.93482197,14593,6
Georgia,GA,Seminole County,1254,19,2611,3884,REP,1357,34.93820803,8729,6
Georgia,GA,Spalding County,11784,275,18057,30116,REP,6273,20.82945942,64073,1
Georgia,GA,Stephens County,2385,132,9368,11885,REP,6983,58.75473286,26175,7
Georgia,GA,Stewart County,1182,7,801,1990,DEM,381,19.14572864,6058,8
Georgia,GA,Sumter County,6318,100,5732,12150,DEM,586,4.823045267,32819,6
Georgia,GA,Talbot County,2114,16,1392,3522,DEM,722,20.49971607,6865,8
Georgia,GA,Taliaferro County,561,7,360,928,DEM,201,21.65948276,1717,8
Georgia,GA,Tattnall County,2061,69,6053,8183,REP,3992,48.78406452,25520,6
Georgia,GA,Taylor County,1387,34,2418,3839,REP,1031,26.85595207,8906,8
Georgia,GA,Telfair County,1487,21,2825,4333,REP,1338,30.87929841,16500,7
Georgia,GA,Terrell County,2376,36,2004,4416,DEM,372,8.423913043,9315,3
Georgia,GA,Thomas County,8708,191,12954,21853,REP,4246,19.42982657,44720,4
Georgia,GA,Tift County,5322,177,10784,16283,REP,5462,33.54418719,40118,5
Georgia,GA,Toombs County,2939,103,7872,10914,REP,4933,45.19882719,27223,7
Georgia,GA,Towns County,1550,45,6384,7979,REP,4834,60.58403309,10471,9
Georgia,GA,Treutlen County,952,24,2101,3077,REP,1149,37.34156646,6885,7
Georgia,GA,Troup County,11585,328,18146,30059,REP,6561,21.82707342,67044,4
Georgia,GA,Turner County,1410,33,2349,3792,REP,939,24.76265823,8930,6
Georgia,GA,Twiggs County,2044,30,2370,4444,REP,326,7.335733573,9023,3
Georgia,GA,Union County,2801,140,12651,15592,REP,9850,63.17342227,21356,9
Georgia,GA,Upson County,4201,96,8608,12905,REP,4407,34.14955444,27153,6
Georgia,GA,Walker County,5769,493,23174,29436,REP,17405,59.1282783,68756,2
Georgia,GA,Walton County,12682,571,37842,51095,REP,25160,49.24160877,83768,1
Georgia,GA,Ware County,4249,117,9930,14296,REP,5681,39.73838836,36312,5
Georgia,GA,Warren County,1488,16,1177,2681,DEM,311,11.6001492,5834,8
Georgia,GA,Washington County,4730,66,4663,9459,DEM,67,0.708320118,21187,7
Georgia,GA,Wayne County,2687,104,9987,12778,REP,7300,57.12944123,30099,6
Georgia,GA,Webster County,639,3,748,1390,REP,109,7.841726619,2799,8
Georgia,GA,Wheeler County,689,13,1583,2285,REP,894,39.12472648,7421,9
Georgia,GA,White County,2411,183,12222,14816,REP,9811,66.21895248,27144,6
Georgia,GA,Whitfield County,10670,440,25636,36746,REP,14966,40.72824253,102599,3
Georgia,GA,Wilcox County,862,16,2403,3281,REP,1541,46.96738799,9255,8
Georgia,GA,Wilkes County,2159,47,2823,5029,REP,664,13.20342016,10593,6
Georgia,GA,Wilkinson County,2075,31,2664,4770,REP,589,12.34800839,9563,8
Georgia,GA,Worth County,2395,60,6831,9286,REP,4436,47.77083782,21679,3
Iowa,IA,Adair County,1197,69,2917,4183,REP,1720,41.11881425,7682,8
Iowa,IA,Adams County,590,40,1528,2158,REP,938,43.46617238,4029,9
Iowa,IA,Allamakee County,2575,151,4733,7459,REP,2158,28.93149216,14330,6
Iowa,IA,Appanoose County,1891,103,4512,6506,REP,2621,40.28588995,12887,7
Iowa,IA,Audubon County,1071,50,2295,3416,REP,1224,35.83138173,6119,8
Iowa,IA,Benton County,5156,292,9179,14627,REP,4023,27.50393109,26076,2
Iowa,IA,Black Hawk County,35621,1305,29623,66549,DEM,5998,9.012907782,131090,3
Iowa,IA,Boone County,6303,308,8695,15306,REP,2392,15.62785836,26306,6
Iowa,IA,Bremer County,5954,293,8287,14534,REP,2333,16.05201596,24276,3
Iowa,IA,Buchanan County,4169,175,6420,10764,REP,2251,20.91230026,20958,6
Iowa,IA,Buena Vista County,2961,132,5056,8149,REP,2095,25.70867591,20260,7
Iowa,IA,Butler County,2424,118,5542,8084,REP,3118,38.57001484,14867,8
Iowa,IA,Calhoun County,1470,90,3689,5249,REP,2219,42.27471899,9670,9
Iowa,IA,Carroll County,3454,115,7737,11306,REP,4283,37.88254024,20816,7
Iowa,IA,Cass County,2201,96,4969,7266,REP,2768,38.0952381,13956,6
Iowa,IA,Cedar County,4337,205,6161,10703,REP,1824,17.04195085,18499,6
Iowa,IA,Cerro Gordo County,10941,418,12435,23794,REP,1494,6.278893839,44151,5
Iowa,IA,Cherokee County,1936,72,4495,6503,REP,2559,39.35106874,12072,6
Iowa,IA,Chickasaw County,2233,76,4308,6617,REP,2075,31.35862173,12439,6
Iowa,IA,Clarke County,1466,60,3140,4666,REP,1674,35.87655379,9286,6
Iowa,IA,Clay County,2662,149,6137,8948,REP,3475,38.83549397,16667,7
Iowa,IA,Clayton County,3340,135,6106,9581,REP,2766,28.86963782,18129,8
Iowa,IA,Clinton County,10806,514,13349,24669,REP,2543,10.30848433,49116,4
Iowa,IA,Crawford County,2220,72,4854,7146,REP,2634,36.8597817,17096,7
Iowa,IA,Dallas County,26879,981,27987,55847,REP,1108,1.983991978,66135,2
Iowa,IA,Davis County,1013,54,3032,4099,REP,2019,49.25591608,8753,9
Iowa,IA,Decatur County,1120,66,2615,3801,REP,1495,39.3317548,8457,9
Iowa,IA,Delaware County,3157,158,6666,9981,REP,3509,35.15679792,17764,6
Iowa,IA,Des Moines County,8887,471,10589,19947,REP,1702,8.53261142,40325,5
Iowa,IA,Dickinson County,3661,131,7438,11230,REP,3777,33.63312556,16667,7
Iowa,IA,Dubuque County,25655,1055,27214,53924,REP,1559,2.891106001,93653,3
Iowa,IA,Emmet County,1520,65,3265,4850,REP,1745,35.97938144,10302,7
Iowa,IA,Fayette County,3834,205,6145,10184,REP,2311,22.69245876,20880,6
Iowa,IA,Floyd County,3168,128,4730,8026,REP,1562,19.46174931,16303,7
Iowa,IA,Franklin County,1626,71,3422,5119,REP,1796,35.08497753,10680,7
Iowa,IA,Fremont County,1078,66,2711,3855,REP,1633,42.36057069,7441,8
Iowa,IA,Greene County,1768,65,3221,5054,REP,1453,28.74950534,9336,6
Iowa,IA,Grundy County,2206,125,4929,7260,REP,2723,37.50688705,12453,3
Iowa,IA,Guthrie County,1985,112,4272,6369,REP,2287,35.90830586,10954,2
Iowa,IA,Hamilton County,2842,718,4956,8516,REP,2114,24.82386097,15673,6
Iowa,IA,Hancock County,1683,88,4390,6161,REP,2707,43.93767246,11341,7
Iowa,IA,Hardin County,2976,149,5850,8975,REP,2874,32.02228412,17534,6
Iowa,IA,Harrison County,2440,135,5569,8144,REP,3129,38.42092338,14928,2
Iowa,IA,Henry County,3275,182,6507,9964,REP,3232,32.43677238,20145,6
Iowa,IA,Howard County,1772,53,3127,4952,REP,1355,27.36268174,9566,6
Iowa,IA,Humboldt County,1442,60,3819,5321,REP,2377,44.67205413,9815,7
Iowa,IA,Ida County,917,52,2876,3845,REP,1959,50.94928479,7089,8
Iowa,IA,Iowa County,3547,160,6009,9716,REP,2462,25.33964594,16355,6
Iowa,IA,Jackson County,4029,149,6940,11118,REP,2911,26.18276668,19848,6
Iowa,IA,Jasper County,7737,362,12082,20181,REP,4345,21.53015212,36842,6
Iowa,IA,Jefferson County,4314,196,4442,8952,REP,128,1.429848079,16843,7
Iowa,IA,Johnson County,59177,1468,22925,83570,DEM,36252,43.37920306,130882,3
Iowa,IA,Jones County,4213,180,6572,10965,REP,2359,21.51390789,20638,2
Iowa,IA,Keokuk County,1414,80,3797,5291,REP,2383,45.03874504,10511,8
Iowa,IA,Kossuth County,2696,106,6275,9077,REP,3579,39.42932687,15543,7
Iowa,IA,Lee County,6539,419,9763,16721,REP,3224,19.28114347,35862,5
Iowa,IA,Linn County,70874,2840,53364,127078,DEM,17510,13.77893892,211226,2
Iowa,IA,Louisa County,1726,100,3500,5326,REP,1774,33.30829891,11387,8
Iowa,IA,Lucas County,1284,59,3287,4630,REP,2003,43.26133909,8898,6
Iowa,IA,Lyon County,1067,78,5707,6852,REP,4640,67.71745476,11581,8
Iowa,IA,Madison County,3134,165,6507,9806,REP,3373,34.39730777,15679,2
Iowa,IA,Mahaska County,2894,190,8297,11381,REP,5403,47.47385994,22381,7
Iowa,IA,Marion County,6170,390,12657,19217,REP,6487,33.7565697,33309,6
Iowa,IA,Marshall County,8171,387,9564,18122,REP,1393,7.686789538,40648,4
Iowa,IA,Mills County,2500,175,5572,8247,REP,3072,37.24990906,15059,2
Iowa,IA,Mitchell County,2053,85,3677,5815,REP,1624,27.927773,10776,7
Iowa,IA,Monona County,1407,59,3248,4714,REP,1841,39.05388205,9243,6
Iowa,IA,Monroe County,1078,32,2975,4085,REP,1897,46.43818849,7970,7
Iowa,IA,Montgomery County,1583,78,3659,5320,REP,2076,39.02255639,10740,6
Iowa,IA,Muscatine County,9372,434,10823,20629,REP,1451,7.033787387,42745,4
Iowa,IA,O'Brien County,1569,111,5861,7541,REP,4292,56.91552844,14398,7
Iowa,IA,Osceola County,600,37,2688,3325,REP,2088,62.79699248,6462,7
Iowa,IA,Page County,2086,114,5319,7519,REP,3233,42.99773906,15932,6
Iowa,IA,Palo Alto County,1519,61,3370,4950,REP,1851,37.39393939,9421,7
Iowa,IA,Plymouth County,3494,179,10492,14165,REP,6998,49.40345923,24986,3
Iowa,IA,Pocahontas County,932,64,2825,3821,REP,1893,49.54200471,7310,9
Iowa,IA,Polk County,146250,4941,106800,257991,DEM,39450,15.29123109,430640,2
Iowa,IA,Pottawattamie County,18570,922,26241,45733,REP,7671,16.77344587,93158,2
Iowa,IA,Poweshiek County,4306,161,5657,10124,REP,1351,13.34452785,18914,7
Iowa,IA,Ringgold County,708,37,1964,2709,REP,1256,46.36397195,5131,9
Iowa,IA,Sac County,1389,77,4061,5527,REP,2672,48.34449068,10350,9
Iowa,IA,Scott County,46890,2088,43661,92639,DEM,3229,3.485573031,165224,2
Iowa,IA,Shelby County,1959,125,4697,6781,REP,2738,40.37752544,12167,6
Iowa,IA,Sioux County,3019,257,15680,18956,REP,12661,66.7915172,33704,7
Iowa,IA,Story County,29175,1322,20340,50837,DEM,8835,17.3790743,89542,3
Iowa,IA,Tama County,3577,146,5303,9026,REP,1726,19.1225349,17767,6
Iowa,IA,Taylor County,746,33,2463,3242,REP,1717,52.9611351,6317,9
Iowa,IA,Union County,2061,100,4010,6171,REP,1949,31.5832118,12534,6
Iowa,IA,Van Buren County,875,54,2859,3788,REP,1984,52.37592397,7570,9
Iowa,IA,Wapello County,5821,276,9516,15613,REP,3695,23.66617562,35625,5
Iowa,IA,Warren County,12537,680,17738,30955,REP,5201,16.80180908,46225,2
Iowa,IA,Washington County,4558,233,6966,11757,REP,2408,20.48141533,21704,3
Iowa,IA,Wayne County,727,38,2338,3103,REP,1611,51.91749919,6403,9
Iowa,IA,Webster County,6604,271,10927,17802,REP,4323,24.28378834,38013,5
Iowa,IA,Winnebago County,2135,109,3707,5951,REP,1572,26.41572845,10866,7
Iowa,IA,Winneshiek County,5617,184,6235,12036,REP,618,5.134596211,21056,7
Iowa,IA,Woodbury County,18704,732,25736,45172,REP,7032,15.5671655,102172,3
Iowa,IA,Worth County,1596,80,2738,4414,REP,1142,25.87222474,7598,9
Iowa,IA,Wright County,1996,110,4136,6242,REP,2140,34.28388337,13229,7
Michigan,MI,Alcona County,2142,73,4848,7063,REP,2706,38.31233187,10942,9
Michigan,MI,Alger County,2053,68,3014,5135,REP,961,18.71470302,9601,7
Michigan,MI,Allegan County,24447,1354,41381,67182,REP,16934,25.20615641,111408,4
Michigan,MI,Alpena County,6000,280,10686,16966,REP,4686,27.61994577,29598,7
Michigan,MI,Antrim County,7289,275,9783,17347,REP,2494,14.37712573,23580,9
Michigan,MI,Arenac County,2774,129,5928,8831,REP,3154,35.71509455,15899,8
Michigan,MI,Baraga County,1478,46,2512,4036,REP,1034,25.61942517,8860,9
Michigan,MI,Barry County,11804,637,23473,35914,REP,11669,32.49150749,59173,2
Michigan,MI,Bay County,26653,985,33347,60985,REP,6694,10.97646962,107771,3
Michigan,MI,Benzie County,5480,179,6601,12260,REP,1121,9.143556281,17525,9
Michigan,MI,Berrien County,37438,1422,43519,82379,REP,6081,7.381735637,156813,3
Michigan,MI,Branch County,6161,313,14067,20541,REP,7906,38.48887591,45248,6
Michigan,MI,Calhoun County,28417,1251,35900,65568,REP,7483,11.41257931,136146,3
Michigan,MI,Cass County,9122,413,16686,26221,REP,7564,28.84710728,52293,2
Michigan,MI,Charlevoix County,6939,220,9841,17000,REP,2902,17.07058824,25949,7
Michigan,MI,Cheboygan County,5437,245,10186,15868,REP,4749,29.9281573,26152,7
Michigan,MI,Chippewa County,6651,342,10682,17675,REP,4031,22.80622348,38520,7
Michigan,MI,Clare County,5200,220,10860,16280,REP,5660,34.76658477,30926,6
Michigan,MI,Clinton County,21968,844,25098,47910,REP,3130,6.533082864,75382,2
Michigan,MI,Crawford County,2612,98,4955,7665,REP,2343,30.56751468,14074,7
Michigan,MI,Delta County,7605,343,13206,21154,REP,5601,26.47726198,37069,5
Michigan,MI,Dickinson County,4744,228,9617,14589,REP,4873,33.40187813,26168,7
Michigan,MI,Eaton County,31297,1357,31797,64451,REP,500,0.775783153,107759,2
Michigan,MI,Emmet County,9662,379,12135,22176,REP,2473,11.15169553,32694,7
Michigan,MI,Genesee County,120082,3688,99199,222969,DEM,20883,9.365875974,425790,2
Michigan,MI,Gladwin County,4524,186,9893,14603,REP,5369,36.76641786,25692,6
Michigan,MI,Gogebic County,3573,106,4600,8279,REP,1027,12.40487982,16427,7
Michigan,MI,Grand Traverse County,28683,1042,30502,60227,REP,1819,3.020240092,86986,5
Michigan,MI,Gratiot County,6693,353,12102,19148,REP,5409,28.24838103,42476,6
Michigan,MI,Hillsdale County,5883,368,17037,23288,REP,11154,47.89591206,46688,6
Michigan,MI,Houghton County,7755,405,10380,18540,REP,2625,14.15857605,36628,5
Michigan,MI,Huron County,5349,225,11949,17523,REP,6600,37.66478343,33118,7
Michigan,MI,Ingham County,94221,2936,47640,144797,DEM,46581,32.1698654,280895,2
Michigan,MI,Ionia County,10901,647,20657,32205,REP,9756,30.2934327,63905,4
Michigan,MI,Iosco County,5371,255,9760,15386,REP,4389,28.52593267,25887,7
Michigan,MI,Iron County,2493,86,4216,6795,REP,1723,25.35688006,11817,7
Michigan,MI,Isabella County,14072,522,14815,29409,REP,743,2.526437485,70311,4
Michigan,MI,Jackson County,32004,1647,47381,81032,REP,15377,18.97645375,160248,3
Michigan,MI,Kalamazoo County,83686,2867,56823,143376,DEM,26863,18.73605066,250331,2
Michigan,MI,Kalkaska County,3003,188,7436,10627,REP,4433,41.7145008,17153,7
Michigan,MI,Kent County,187915,7183,165741,360839,DEM,22174,6.145122894,602622,2
Michigan,MI,Keweenaw County,672,23,862,1557,REP,190,12.2029544,2156,9
Michigan,MI,Lake County,2288,98,3946,6332,REP,1658,26.18445989,11539,9
Michigan,MI,Lapeer County,16368,791,35480,52639,REP,19112,36.30768062,88319,1
Michigan,MI,Leelanau County,8793,222,7915,16930,DEM,878,5.186060248,21708,9
Michigan,MI,Lenawee County,20916,993,31539,53448,REP,10623,19.87539291,99892,4
Michigan,MI,Livingston County,48220,1964,76982,127166,REP,28762,22.61768083,180967,1
Michigan,MI,Luce County,842,150,2109,3101,REP,1267,40.85778781,6631,7
Michigan,MI,Mackinac County,2632,79,4304,7015,REP,1672,23.83464006,11113,7
Michigan,MI,Macomb County,225561,6427,264535,496523,REP,38974,7.849384621,840978,1
Michigan,MI,Manistee County,6107,226,8321,14654,REP,2214,15.1085028,24733,7
Michigan,MI,Marquette County,20465,707,16288,37460,DEM,4177,11.1505606,67077,5
Michigan,MI,Mason County,6802,240,10207,17249,REP,3405,19.7402748,28705,7
Michigan,MI,Mecosta County,7373,439,13265,21077,REP,5892,27.9546425,42798,6
Michigan,MI,Menominee County,4314,188,8120,12622,REP,3806,30.15369989,24029,7
Michigan,MI,Midland County,20493,1007,27675,49175,REP,7182,14.60498221,83629,3
Michigan,MI,Missaukee County,1967,140,6648,8755,REP,4681,53.46659052,14849,9
Michigan,MI,Monroe County,32975,1463,52710,87148,REP,19735,22.64538486,152021,3
Michigan,MI,Montcalm County,9703,568,21815,32086,REP,12112,37.74855077,63342,2
Michigan,MI,Montmorency County,1628,64,4171,5863,REP,2543,43.37369947,9765,9
Michigan,MI,Muskegon County,45508,1649,44544,91701,DEM,964,1.051242625,172188,3
Michigan,MI,Newaygo County,7874,426,18864,27164,REP,10990,40.45795906,48460,6
Michigan,MI,Oakland County,433982,11871,325916,771769,DEM,108066,14.00237636,1202362,1
Michigan,MI,Oceana County,4944,244,8892,14080,REP,3948,28.03977273,26570,6
Michigan,MI,Ogemaw County,3475,179,8253,11907,REP,4778,40.127656,21699,9
Michigan,MI,Ontonagon County,1391,61,2358,3810,REP,967,25.38057743,6780,9
Michigan,MI,Osceola County,3214,198,8928,12340,REP,5714,46.30470016,23528,9
Michigan,MI,Oscoda County,1342,66,3466,4874,REP,2124,43.57816988,8640,9
Michigan,MI,Otsego County,4743,234,9779,14756,REP,5036,34.12849011,24164,7
Michigan,MI,Ottawa County,64705,3009,100913,168627,REP,36208,21.47224347,263801,2
Michigan,MI,Presque Isle County,2912,105,5343,8360,REP,2431,29.07894737,13376,7
Michigan,MI,Roscommon County,5166,182,9670,15018,REP,4504,29.99067785,24449,7
Michigan,MI,Saginaw County,51088,1474,50785,103347,DEM,303,0.29318703,200169,3
Michigan,MI,Sanilac County,5966,286,16194,22446,REP,10228,45.56713891,43114,6
Michigan,MI,Schoolcraft County,1589,66,3090,4745,REP,1501,31.63329821,8485,7
Michigan,MI,Shiawassee County,15371,725,23154,39250,REP,7783,19.82929936,70648,4
Michigan,MI,St. Clair County,31363,1515,59186,92064,REP,27823,30.22136774,163040,1
Michigan,MI,St. Joseph County,9262,592,18128,27982,REP,8866,31.68465442,61295,4
Michigan,MI,Tuscola County,8713,472,20310,29495,REP,11597,39.31852856,55729,6
Michigan,MI,Van Buren County,16803,669,21591,39063,REP,4788,12.25712311,76258,2
Michigan,MI,Washtenaw County,157130,3553,56241,216924,DEM,100889,46.50891556,344791,2
Michigan,MI,Wayne County,587074,10598,264149,861821,DEM,322925,37.47007789,1820584,1
Michigan,MI,Wexford County,5838,352,12102,18292,REP,6264,34.24447846,32735,7
Minnesota,MN,Aitkin County,3607,145,6258,10010,REP,2651,26.48351648,16202,8
Minnesota,MN,Anoka County,100892,4696,104903,210491,REP,4011,1.905544655,330844,1
Minnesota,MN,Becker County,6592,374,12452,19418,REP,5860,30.17818519,32504,6
Minnesota,MN,Beltrami County,11426,517,12188,24131,REP,762,3.157763872,44442,7
Minnesota,MN,Benton County,7281,556,14382,22219,REP,7101,31.95913407,38451,3
Minnesota,MN,Big Stone County,1052,58,1862,2972,REP,810,27.25437416,5269,9
Minnesota,MN,Blue Earth County,18330,908,16731,35969,DEM,1599,4.445494732,64013,3
Minnesota,MN,Brown County,4750,330,9550,14630,REP,4800,32.80929597,25893,6
Minnesota,MN,Carlton County,10094,480,9787,20361,DEM,307,1.50778449,35386,2
Minnesota,MN,Carver County,30770,1337,34012,66119,REP,3242,4.903280449,91042,1
Minnesota,MN,Cass County,6342,293,11621,18256,REP,5279,28.9165206,28567,9
Minnesota,MN,Chippewa County,2226,135,4250,6611,REP,2024,30.6156406,12441,7
Minnesota,MN,Chisago County,11803,775,21915,34493,REP,10112,29.31609312,53887,1
Minnesota,MN,Clay County,16345,839,15031,32215,DEM,1314,4.078845258,58999,3
Minnesota,MN,Clearwater County,1258,76,3371,4705,REP,2113,44.90967056,8695,8
Minnesota,MN,Cook County,2496,86,1203,3785,DEM,1293,34.16116248,5176,9
Minnesota,MN,Cottonwood County,1834,98,4165,6097,REP,2331,38.23191734,11687,7
Minnesota,MN,Crow Wing County,13726,671,25676,40073,REP,11950,29.82057745,62500,4
Minnesota,MN,Dakota County,145510,6414,109183,261107,DEM,36327,13.91268714,398552,1
Minnesota,MN,Dodge County,4074,305,7774,12153,REP,3700,30.44515757,20087,3
Minnesota,MN,Douglas County,7868,453,15799,24120,REP,7931,32.8814262,36009,6
Minnesota,MN,Faribault County,2531,170,5191,7892,REP,2660,33.70501774,14553,6
Minnesota,MN,Fillmore County,4551,252,7301,12104,REP,2750,22.71976206,20866,3
Minnesota,MN,Freeborn County,6889,324,9578,16791,REP,2689,16.01453159,31255,7
Minnesota,MN,Goodhue County,11805,709,16052,28566,REP,4247,14.86732479,46183,4
Minnesota,MN,Grant County,1300,81,2269,3650,REP,969,26.54794521,6018,9
Minnesota,MN,Hennepin County,532608,14585,205966,753159,DEM,326642,43.36959394,1152425,1
Minnesota,MN,Houston County,4851,253,6334,11438,REP,1483,12.96555342,19027,3
Minnesota,MN,Hubbard County,4462,263,8202,12927,REP,3740,28.93169335,20428,7
Minnesota,MN,Isanti County,7138,533,16491,24162,REP,9353,38.70954391,37816,1
Minnesota,MN,Itasca County,10787,486,15239,26512,REP,4452,16.7923959,45058,6
Minnesota,MN,Jackson County,1745,120,3948,5813,REP,2203,37.89781524,10266,7
Minnesota,MN,Kanabec County,2774,172,6278,9224,REP,3504,37.98785776,16239,6
Minnesota,MN,Kandiyohi County,8440,436,14437,23313,REP,5997,25.72384506,42239,4
Minnesota,MN,Kittson County,1006,87,1546,2639,REP,540,20.46229632,4552,9
Minnesota,MN,Koochiching County,2657,132,4131,6920,REP,1474,21.30057803,13311,6
Minnesota,MN,Lac qui Parle County,1445,67,2527,4039,REP,1082,26.78880911,7259,9
Minnesota,MN,Lake County,3646,162,3392,7200,DEM,254,3.527777778,10866,6
Minnesota,MN,Lake of the Woods County,671,30,1704,2405,REP,1033,42.95218295,4045,9
Minnesota,MN,Le Sueur County,5671,329,10775,16775,REP,5104,30.42622951,27703,1
Minnesota,MN,Lincoln County,937,57,2120,3114,REP,1183,37.98972383,5896,9
Minnesota,MN,Lyon County,4630,280,7979,12889,REP,3349,25.98339669,25857,7
Minnesota,MN,Mahnomen County,1112,48,1143,2303,REP,31,1.346070343,5413,8
Minnesota,MN,Marshall County,1295,85,3721,5101,REP,2426,47.5593021,9439,8
Minnesota,MN,Martin County,3304,258,7476,11038,REP,4172,37.7967023,20840,7
Minnesota,MN,McLeod County,6413,489,13986,20888,REP,7573,36.25526618,36651,6
Minnesota,MN,Meeker County,3867,271,9358,13496,REP,5491,40.68612922,23300,6
Minnesota,MN,Mille Lacs County,4403,310,9953,14666,REP,5550,37.84262921,26097,1
Minnesota,MN,Morrison County,4367,337,14819,19523,REP,10452,53.53685397,33198,6
Minnesota,MN,Mower County,8997,377,10067,19441,REP,1070,5.503832107,39163,4
Minnesota,MN,Murray County,1449,71,3363,4883,REP,1914,39.19721483,8725,9
Minnesota,MN,Nicollet County,9622,484,9018,19124,DEM,604,3.158335076,32727,3
Minnesota,MN,Nobles County,2928,182,5598,8708,REP,2670,30.66146073,21378,7
Minnesota,MN,Norman County,1404,76,1954,3434,REP,550,16.01630751,6852,8
Minnesota,MN,Olmsted County,49492,1902,39692,91086,DEM,9800,10.75906286,144248,3
Minnesota,MN,Otter Tail County,11940,638,23794,36372,REP,11854,32.59100407,57303,6
Minnesota,MN,Pennington County,2568,163,4532,7263,REP,1964,27.04116756,13930,6
Minnesota,MN,Pine County,5416,326,10256,15998,REP,4840,30.25378172,29750,6
Minnesota,MN,Pipestone County,1306,73,3553,4932,REP,2247,45.55961071,9596,6
Minnesota,MN,Polk County,5435,289,9857,15581,REP,4422,28.38072011,31600,3
Minnesota,MN,Pope County,2478,128,4413,7019,REP,1935,27.56802963,10995,8
Minnesota,MN,Ramsey County,211362,5827,77324,294513,DEM,134038,45.51174311,508640,1
Minnesota,MN,Red Lake County,689,51,1450,2190,REP,761,34.74885845,4089,8
Minnesota,MN,Redwood County,2358,157,5775,8290,REP,3417,41.21833534,16059,7
Minnesota,MN,Renville County,2497,153,5465,8115,REP,2968,36.57424522,15730,8
Minnesota,MN,Rice County,17402,743,17463,35608,REP,61,0.171309818,64142,4
Minnesota,MN,Rock County,1554,101,3580,5235,REP,2026,38.70105062,9687,6
Minnesota,MN,Roseau County,2188,155,6065,8408,REP,3877,46.11084681,15629,7
Minnesota,MN,Scott County,40037,1821,45871,87729,REP,5834,6.650024507,129928,1
Minnesota,MN,Sherburne County,18065,1200,36221,55486,REP,18156,32.72176765,88499,1
Minnesota,MN,Sibley County,2417,170,5864,8451,REP,3447,40.78807242,15226,1
Minnesota,MN,St. Louis County,67836,2809,49214,119859,DEM,18622,15.53658883,200226,2
Minnesota,MN,Stearns County,31883,1804,50960,84647,REP,19077,22.53712477,150642,3
Minnesota,MN,Steele County,7917,503,12656,21076,REP,4739,22.48529133,36576,5
Minnesota,MN,Stevens County,1921,97,3044,5062,REP,1123,22.18490715,9726,7
Minnesota,MN,Swift County,1784,85,3316,5185,REP,1532,29.54676953,9783,7
Minnesota,MN,Todd County,3286,197,9755,13238,REP,6469,48.86689832,24895,6
Minnesota,MN,Traverse County,662,29,1173,1864,REP,511,27.41416309,3558,9
Minnesota,MN,Wabasha County,4696,248,8153,13097,REP,3457,26.39535772,21676,3
Minnesota,MN,Wadena County,2023,118,5520,7661,REP,3497,45.6467824,13843,7
Minnesota,MN,Waseca County,3496,269,6624,10389,REP,3128,30.10876889,19136,6
Minnesota,MN,Washington County,89164,3339,73764,166267,DEM,15400,9.262210781,238136,1
Minnesota,MN,Watonwan County,1987,101,3103,5191,REP,1116,21.49874783,11211,6
Minnesota,MN,Wilkin County,1027,75,2333,3435,REP,1306,38.02037846,6576,6
Minnesota,MN,Winona County,13333,548,13227,27108,DEM,106,0.391028479,51461,4
Minnesota,MN,Wright County,28427,2023,51970,82420,REP,23543,28.56466877,124700,1
Minnesota,MN,Yellow Medicine County,1685,106,3734,5525,REP,2049,37.08597285,10438,9
Nevada,NV,Carson City,12735,891,16113,29739,REP,3378,11.35882175,55274,3
Nevada,NV,Churchill County,3051,467,9372,12890,REP,6321,49.03801396,24877,6
Nevada,NV,Clark County,521852,19728,430930,972510,DEM,90922,9.349209777,1951269,1
Nevada,NV,Douglas County,11571,924,21630,34125,REP,10059,29.47692308,46997,4
Nevada,NV,Elko County,4557,669,16741,21967,REP,12184,55.46501571,48818,5
Nevada,NV,Esmeralda County,74,13,400,487,REP,326,66.94045175,783,9
Nevada,NV,Eureka County,105,17,895,1017,REP,790,77.67944936,1987,9
Nevada,NV,Humboldt County,1689,205,5877,7771,REP,4188,53.89267791,16528,7
Nevada,NV,Lander County,496,71,2198,2765,REP,1702,61.55515371,5775,7
Nevada,NV,Lincoln County,330,49,2067,2446,REP,1737,71.01390025,5345,8
Nevada,NV,Lyon County,8473,851,20914,30238,REP,12441,41.14359415,51980,4
Nevada,NV,Mineral County,829,83,1423,2335,REP,594,25.43897216,4772,7
Nevada,NV,Nye County,7288,562,17528,25378,REP,10240,40.34990937,43946,4
Nevada,NV,Pershing County,547,42,1731,2320,REP,1184,51.03448276,6753,9
Nevada,NV,Storey County,902,67,1908,2877,REP,1006,34.96697949,4010,2
Nevada,NV,Washoe County,128128,7254,116760,252142,DEM,11368,4.508570567,421407,2
Nevada,NV,White Pine County,859,107,3403,4369,REP,2544,58.22842756,10030,7
Ohio,OH,Adams County,2130,115,9660,11905,REP,7530,63.25073499,28550,6
Ohio,OH,Allen County,13611,699,32052,46362,REP,18441,39.77610975,106331,3
Ohio,OH,Ashland County,6448,433,19002,25883,REP,12554,48.50287834,53139,4
Ohio,OH,Ashtabula County,16207,821,26225,43253,REP,10018,23.16139921,101497,4
Ohio,OH,Athens County,14047,443,10386,24876,DEM,3661,14.7169963,64757,4
Ohio,OH,Auglaize County,4583,362,20451,25396,REP,15868,62.48228067,45949,4
Ohio,OH,Belmont County,9007,435,23092,32534,REP,14085,43.29317022,70400,3
Ohio,OH,Brown County,4326,228,16032,20586,REP,11706,56.86388808,44846,1
Ohio,OH,Butler County,67729,2583,111722,182034,REP,43993,24.16746322,368130,1
Ohio,OH,Carroll County,3206,226,10525,13957,REP,7319,52.43963602,28836,2
Ohio,OH,Champaign County,4946,337,14086,19369,REP,9140,47.18880686,40097,6
Ohio,OH,Clark County,23625,1028,38217,62870,REP,14592,23.209798,138333,3
Ohio,OH,Clermont County,33505,1733,73077,108315,REP,39572,36.53418271,197363,1
Ohio,OH,Clinton County,4556,323,15061,19940,REP,10505,52.68304915,42040,6
Ohio,OH,Columbiana County,13183,862,35124,49169,REP,21941,44.62364498,107841,4
Ohio,OH,Coshocton County,4057,309,11982,16348,REP,7925,48.47687791,36901,6
Ohio,OH,Crawford County,4831,348,15043,20222,REP,10212,50.49945604,43784,4
Ohio,OH,Cuyahoga County,402315,6317,195089,603721,DEM,207226,34.32479573,1280122,1
Ohio,OH,Darke County,4668,384,21569,26621,REP,16901,63.4874723,52959,6
Ohio,OH,Defiance County,5870,384,12778,19032,REP,6908,36.29676335,39037,4
Ohio,OH,Delaware County,56961,1880,65163,124004,REP,8202,6.614302764,174214,1
Ohio,OH,Erie County,17142,657,21724,39523,REP,4582,11.5932495,77079,4
Ohio,OH,Fairfield County,30634,1216,49714,81564,REP,19080,23.39267324,146156,1
Ohio,OH,Fayette County,2911,174,9220,12305,REP,6309,51.27184072,29030,6
Ohio,OH,Franklin County,391584,9320,203154,604058,DEM,188430,31.19402441,1163414,1
Ohio,OH,Fulton County,6545,358,15396,22299,REP,8851,39.69236289,42698,2
Ohio,OH,Gallia County,2911,158,10289,13358,REP,7378,55.23281928,30934,6
Ohio,OH,Geauga County,20980,820,33581,55381,REP,12601,22.75329084,93389,1
Ohio,OH,Greene County,34023,1656,50937,86616,REP,16914,19.52756996,161573,2
Ohio,OH,Guernsey County,4498,231,13077,17806,REP,8579,48.18038863,40087,6
Ohio,OH,Hamilton County,238101,6292,173015,417408,DEM,65086,15.59289712,802374,1
Ohio,OH,Hancock County,11535,668,25796,37999,REP,14261,37.529935,74782,4
Ohio,OH,Hardin County,3025,231,9698,12954,REP,6673,51.51304616,32058,6
Ohio,OH,Harrison County,1742,90,5668,7500,REP,3926,52.34666667,15864,6
Ohio,OH,Henry County,3995,214,10273,14482,REP,6278,43.35036597,28215,6
Ohio,OH,Highland County,3741,193,15369,19303,REP,11628,60.23934104,43589,6
Ohio,OH,Hocking County,3836,396,9554,13786,REP,5718,41.47686058,29380,1
Ohio,OH,Holmes County,1981,183,10645,12809,REP,8664,67.63994067,42366,7
Ohio,OH,Huron County,7643,448,18537,26628,REP,10894,40.91182214,59626,4
Ohio,OH,Jackson County,3193,163,10804,14160,REP,7611,53.75,33225,7
Ohio,OH,Jefferson County,9823,440,22309,32572,REP,12486,38.33353801,69709,3
Ohio,OH,Knox County,8433,445,21825,30703,REP,13392,43.6178875,60921,4
Ohio,OH,Lake County,54337,1915,71615,127867,REP,17278,13.51247781,230041,1
Ohio,OH,Lawrence County,7353,315,19759,27427,REP,12406,45.2327998,62450,2
Ohio,OH,Licking County,32324,1541,57965,91830,REP,25641,27.92224763,166492,1
Ohio,OH,Logan County,4990,370,17625,22985,REP,12635,54.97063302,45858,6
Ohio,OH,Lorain County,72792,2477,76719,151988,REP,3927,2.583756612,301356,1
Ohio,OH,Lucas County,111989,3265,79628,194882,DEM,32361,16.60543303,441815,2
Ohio,OH,Madison County,5558,306,13445,19309,REP,7887,40.84623751,43435,1
Ohio,OH,Mahoning County,56346,1618,58601,116565,REP,2255,1.934542959,238823,2
Ohio,OH,Marion County,8089,511,18526,27126,REP,10437,38.47600088,66501,4
Ohio,OH,Medina County,39326,1601,63451,104378,REP,24125,23.11310813,172332,1
Ohio,OH,Meigs County,2452,149,8163,10764,REP,5711,53.05648458,23770,6
Ohio,OH,Mercer County,3981,300,19145,23426,REP,15164,64.73149492,40814,7
Ohio,OH,Miami County,15420,1017,40531,56968,REP,25111,44.07913214,102506,2
Ohio,OH,Monroe County,1597,77,5392,7066,REP,3795,53.70789697,14642,8
Ohio,OH,Montgomery County,131592,4172,126085,261849,DEM,5507,2.103120501,535153,2
Ohio,OH,Morgan County,1703,86,4932,6721,REP,3229,48.04344592,15054,6
Ohio,OH,Morrow County,3988,316,13784,18088,REP,9796,54.15745245,34827,1
Ohio,OH,Muskingum County,11755,604,27334,39693,REP,15579,39.24873403,86074,4
Ohio,OH,Noble County,1156,41,5024,6221,REP,3868,62.17649896,14645,7
Ohio,OH,Ottawa County,8847,393,14285,23525,REP,5438,23.11583422,41428,4
Ohio,OH,Paulding County,2172,181,6927,9280,REP,4755,51.23922414,19614,6
Ohio,OH,Perry County,4006,214,11959,16179,REP,7953,49.15631374,36058,1
Ohio,OH,Pickaway County,7167,404,20059,27630,REP,12892,46.65942816,55698,1
Ohio,OH,Pike County,3051,140,8872,12063,REP,5821,48.25499461,28709,7
Ohio,OH,Portage County,34935,1311,45034,81280,REP,10099,12.42495079,161419,2
Ohio,OH,Preble County,4435,305,16697,21437,REP,12262,57.20016793,42270,6
Ohio,OH,Putnam County,3152,301,16218,19671,REP,13066,66.42265264,34499,6
Ohio,OH,Richland County,17231,836,40534,58601,REP,23303,39.76553301,124475,3
Ohio,OH,Ross County,10345,499,21687,32531,REP,11342,34.8652055,78064,4
Ohio,OH,Sandusky County,10391,612,18487,29490,REP,8096,27.45337403,60944,4
Ohio,OH,Scioto County,8876,344,21926,31146,REP,13050,41.89944134,79499,4
Ohio,OH,Seneca County,8147,436,16739,25322,REP,8592,33.93096912,56745,4
Ohio,OH,Shelby County,4399,398,19988,24785,REP,15589,62.89691346,49423,4
Ohio,OH,Stark County,74336,2768,108610,185714,REP,34274,18.45525916,375586,2
Ohio,OH,Summit County,148151,3741,122023,273915,DEM,26128,9.538725517,541781,2
Ohio,OH,Trumbull County,43534,1387,53756,98677,REP,10222,10.35905023,210312,2
Ohio,OH,Tuscarawas County,12643,623,29519,42785,REP,16876,39.44373028,92582,4
Ohio,OH,Union County,10985,620,21233,32838,REP,10248,31.20774712,52300,1
Ohio,OH,Van Wert County,3026,271,11470,14767,REP,8444,57.18155346,28744,6
Ohio,OH,Vinton County,1306,71,4525,5902,REP,3219,54.54083362,13435,8
Ohio,OH,Warren County,45040,2282,85069,132391,REP,40029,30.23543896,212693,1
Ohio,OH,Washington County,9114,470,21798,31382,REP,12684,40.41807406,61778,4
Ohio,OH,Wayne County,16340,841,36059,53240,REP,19719,37.0379414,114520,4
Ohio,OH,Williams County,4726,346,13218,18290,REP,8492,46.42974303,37642,6
Ohio,OH,Wood County,29797,1248,34815,65860,REP,5018,7.619192226,125488,2
Ohio,OH,Wyandot County,2690,184,8248,11122,REP,5558,49.97302643,22615,7
Pennsylvania,PA,Adams County,18254,814,37567,56635,REP,19313,34.10082105,101407,3
Pennsylvania,PA,Allegheny County,428876,11099,282170,722145,DEM,146706,20.31531064,1223348,1
Pennsylvania,PA,Armstrong County,8453,424,27479,36356,REP,19026,52.33248982,68941,1
Pennsylvania,PA,Beaver County,37747,1228,54108,93083,REP,16361,17.57678631,170539,1
Pennsylvania,PA,Bedford County,4367,182,23025,27574,REP,18658,67.66519185,49762,6
Pennsylvania,PA,Berks County,89530,2789,105941,198260,REP,16411,8.277514375,411442,2
Pennsylvania,PA,Blair County,17636,653,45306,63595,REP,27670,43.50970988,127089,3
Pennsylvania,PA,Bradford County,8044,513,21586,30143,REP,13542,44.92585343,62622,6
Pennsylvania,PA,Bucks County,204511,4152,187274,395937,DEM,17237,4.353470375,625249,1
Pennsylvania,PA,Butler County,37379,1432,74279,113090,REP,36900,32.62887965,183862,1
Pennsylvania,PA,Cambria County,21752,759,48094,70605,REP,26342,37.30897245,143679,3
Pennsylvania,PA,Cameron County,634,29,1771,2434,REP,1137,46.71322925,5085,7
Pennsylvania,PA,Carbon County,11083,429,21773,33285,REP,10690,32.11656903,65249,2
Pennsylvania,PA,Centre County,40054,1065,36371,77490,DEM,3683,4.752871338,153990,3
Pennsylvania,PA,Chester County,181170,4786,127693,313649,DEM,53477,17.04995074,498886,1
Pennsylvania,PA,Clarion County,4671,237,14550,19458,REP,9879,50.77089115,39988,6
Pennsylvania,PA,Clearfield County,9673,620,29203,39496,REP,19530,49.44804537,81642,4
Pennsylvania,PA,Clinton County,5501,221,11897,17619,REP,6396,36.30171973,39238,4
Pennsylvania,PA,Columbia County,10532,541,20098,31171,REP,9566,30.68878124,67295,3
Pennsylvania,PA,Crawford County,12610,513,28002,41125,REP,15392,37.42735562,88765,4
Pennsylvania,PA,Cumberland County,62237,2138,77212,141587,REP,14975,10.57653598,235406,2
Pennsylvania,PA,Dauphin County,78912,1977,66365,147254,DEM,12547,8.520651391,268100,2
Pennsylvania,PA,Delaware County,206615,2981,118627,328223,DEM,87988,26.807384,558979,1
Pennsylvania,PA,Elk County,4517,244,12135,16896,REP,7618,45.0875947,31946,7
Pennsylvania,PA,Erie County,68336,1936,66912,137184,DEM,1424,1.038021927,280566,2
Pennsylvania,PA,Fayette County,19518,445,39978,59941,REP,20460,34.13356467,136606,1
Pennsylvania,PA,Forest County,715,42,1864,2621,REP,1149,43.83822968,7716,9
Pennsylvania,PA,Franklin County,22468,1120,57308,80896,REP,34840,43.06764241,149618,3
Pennsylvania,PA,Fulton County,1085,69,6824,7978,REP,5739,71.93532214,14845,8
Pennsylvania,PA,Greene County,4900,179,12556,17635,REP,7656,43.41366601,38686,6
Pennsylvania,PA,Huntingdon County,5448,286,17059,22793,REP,11611,50.9410784,45913,6
Pennsylvania,PA,Indiana County,12634,475,28087,41196,REP,15453,37.51092339,88880,4
Pennsylvania,PA,Jefferson County,4527,337,17960,22824,REP,13433,58.85471434,45200,7
Pennsylvania,PA,Juniata County,2253,141,9648,12042,REP,7395,61.41006477,24636,6
Pennsylvania,PA,Lackawanna County,61768,1083,52206,115057,DEM,9562,8.31066341,214437,2
Pennsylvania,PA,Lancaster County,115294,5289,159902,280485,REP,44608,15.90388078,519445,2
Pennsylvania,PA,Lawrence County,15978,501,29597,46076,REP,13619,29.5576873,91108,4
Pennsylvania,PA,Lebanon County,23932,1195,46731,71858,REP,22799,31.72785215,133568,3
Pennsylvania,PA,Lehigh County,95889,2108,82287,180284,DEM,13602,7.544762708,349497,2
Pennsylvania,PA,Luzerne County,64873,1519,86929,153321,REP,22056,14.38550492,320918,2
Pennsylvania,PA,Lycoming County,16971,821,41462,59254,REP,24491,41.33223074,116111,3
Pennsylvania,PA,McKean County,5076,284,14067,19427,REP,8991,46.28094919,43450,7
Pennsylvania,PA,Mercer County,20984,905,36059,57948,REP,15075,26.01470284,116638,2
Pennsylvania,PA,Mifflin County,4599,229,16663,21491,REP,12064,56.13512633,46682,4
Pennsylvania,PA,Monroe County,43884,1040,38642,83566,DEM,5242,6.272886102,169842,3
Pennsylvania,PA,Montgomery County,318041,5171,184698,507910,DEM,133343,26.25327322,799874,1
Pennsylvania,PA,Montour County,3768,202,5842,9812,REP,2074,21.1373828,18267,3
Pennsylvania,PA,Northampton County,84847,2453,83732,171032,DEM,1115,0.651924786,297735,2
Pennsylvania,PA,Northumberland County,12703,657,28975,42335,REP,16272,38.43628204,94528,4
Pennsylvania,PA,Perry County,5950,409,18293,24652,REP,12343,50.06895992,45969,2
Pennsylvania,PA,Philadelphia County,604175,4854,132870,741899,DEM,471305,63.52684125,1526006,1
Pennsylvania,PA,Pike County,13052,323,19241,32616,REP,6189,18.97534952,57369,1
Pennsylvania,PA,Potter County,1716,99,7216,9031,REP,5500,60.90133983,17457,9
Pennsylvania,PA,Schuylkill County,20425,997,48100,69522,REP,27675,39.80754294,148289,4
Pennsylvania,PA,Snyder County,4910,247,13983,19140,REP,9073,47.40334378,39702,7
Pennsylvania,PA,Somerset County,8543,414,31105,40062,REP,22562,56.31770755,77742,4
Pennsylvania,PA,Sullivan County,921,56,2622,3599,REP,1701,47.26312865,6428,8
Pennsylvania,PA,Susquehanna County,6084,362,14879,21325,REP,8795,41.24267292,43356,6
Pennsylvania,PA,Tioga County,4959,379,15753,21091,REP,10794,51.17822768,41981,6
Pennsylvania,PA,Union County,7475,284,12356,20115,REP,4881,24.26547353,44947,4
Pennsylvania,PA,Venango County,7585,374,18569,26528,REP,10984,41.4053076,54984,4
Pennsylvania,PA,Warren County,5987,394,14020,20401,REP,8033,39.37552081,41815,6
Pennsylvania,PA,Washington County,44746,1300,71397,117443,REP,26651,22.69271051,207820,1
Pennsylvania,PA,Wayne County,9191,261,18637,28089,REP,9446,33.62882267,52822,6
Pennsylvania,PA,Westmoreland County,71099,2797,128596,202492,REP,57497,28.39470201,365169,1
Pennsylvania,PA,Wyoming County,4704,218,9936,14858,REP,5232,35.21335308,28276,2
Pennsylvania,PA,York County,88023,3618,146606,238247,REP,58583,24.58918685,434972,2
Texas,TX,Anderson County,3934,159,15062,19155,REP,11128,58.0944923,58458,7
Texas,TX,Andrews County,849,70,4937,5856,REP,4088,69.80874317,14786,6
Texas,TX,Angelina County,9136,422,25070,34628,REP,15934,46.01478572,86771,5
Texas,TX,Aransas County,2896,135,9210,12241,REP,6314,51.58075321,23158,2
Texas,TX,Archer County,446,50,4300,4796,REP,3854,80.35863219,9054,3
Texas,TX,Armstrong County,75,2,1035,1112,REP,960,86.33093525,1901,2
Texas,TX,Atascosa County,5865,200,12020,18085,REP,6155,34.03372961,44911,1
Texas,TX,Austin County,2931,155,11282,14368,REP,8351,58.12221604,28417,1
Texas,TX,Bailey County,407,17,1430,1854,REP,1023,55.17799353,7165,7
Texas,TX,Bandera County,2503,150,10050,12703,REP,7547,59.41116272,20485,1
Texas,TX,Bastrop County,15452,771,20486,36709,REP,5034,13.71325833,74171,1
Texas,TX,Baylor County,179,23,1478,1680,REP,1299,77.32142857,3726,8
Texas,TX,Bee County,3280,126,5999,9405,REP,2719,28.91015417,31861,6
Texas,TX,Bell County,56032,2722,67113,125867,REP,11081,8.803737278,310235,2
Texas,TX,Bexar County,440823,11327,303871,756021,DEM,136952,18.11484073,1714773,1
Texas,TX,Blanco County,1905,85,5429,7419,REP,3524,47.49966303,10497,8
Texas,TX,Borden County,16,1,395,412,REP,379,91.99029126,641,8
Texas,TX,Bosque County,1552,96,7446,9094,REP,5894,64.81196393,18212,6
Texas,TX,Bowie County,10692,449,27053,38194,REP,16361,42.83657119,92565,3
Texas,TX,Brazoria County,61780,2318,89939,154037,REP,28159,18.28067283,313166,1
Texas,TX,Brazos County,35242,2055,47456,84753,REP,12214,14.41128928,194851,3
Texas,TX,Brewster County,2251,103,2451,4805,REP,200,4.162330905,9232,7
Texas,TX,Briscoe County,77,8,639,724,REP,562,77.62430939,1637,9
Texas,TX,Brooks County,1470,16,998,2484,DEM,472,19.00161031,7223,7
Texas,TX,Brown County,2103,156,13681,15940,REP,11578,72.6348808,38106,5
Texas,TX,Burleson County,1786,78,6740,8604,REP,4954,57.57787076,17187,3
Texas,TX,Burnet County,5615,310,18721,24646,REP,13106,53.17698612,42750,6
Texas,TX,Caldwell County,6536,264,7975,14775,REP,1439,9.739424704,38066,1
Texas,TX,Calhoun County,2146,67,5640,7853,REP,3494,44.49255062,21381,6
Texas,TX,Callahan County,734,86,6006,6826,REP,5272,77.23410489,13544,3
Texas,TX,Cameron County,63732,1223,48834,113789,DEM,14898,13.09265395,406220,2
Texas,TX,Camp County,1392,39,3626,5057,REP,2234,44.17638916,12401,6
Texas,TX,Carson County,289,45,2747,3081,REP,2458,79.77929244,6182,2
Texas,TX,Cass County,2777,100,10979,13856,REP,8202,59.19457275,30464,6
Texas,TX,Castro County,466,15,1601,2082,REP,1135,54.51488953,8062,6
Texas,TX,Chambers County,3997,301,17343,21641,REP,13346,61.66997828,35096,1
Texas,TX,Cherokee County,4196,196,15065,19457,REP,10869,55.86164362,50845,6
Texas,TX,Childress County,305,26,1928,2259,REP,1623,71.84594954,7041,7
Texas,TX,Clay County,614,58,5064,5736,REP,4450,77.58019526,10752,3
Texas,TX,Cochran County,176,14,806,996,REP,630,63.25301205,3127,9
Texas,TX,Coke County,215,14,1565,1794,REP,1350,75.25083612,3320,8
Texas,TX,Coleman County,451,37,3640,4128,REP,3189,77.25290698,8895,6
Texas,TX,Collin County,230945,8953,252318,492216,REP,21373,4.34219936,782341,1
Texas,TX,Collingsworth County,155,15,1048,1218,REP,893,73.31691297,3057,9
Texas,TX,Colorado County,2403,69,7440,9912,REP,5037,50.81719128,20874,6
Texas,TX,Comal County,24369,1313,62260,87942,REP,37891,43.08635237,108472,1
Texas,TX,Comanche County,852,55,5177,6084,REP,4325,71.08809993,13974,7
Texas,TX,Concho County,197,13,1058,1268,REP,861,67.9022082,4087,8
Texas,TX,Cooke County,3205,182,15579,18966,REP,12374,65.24306654,38437,6
Texas,TX,Coryell County,7542,486,15397,23425,REP,7855,33.53255069,75388,2
Texas,TX,Cottle County,113,9,543,665,REP,430,64.66165414,1505,9
Texas,TX,Crane County,241,15,1247,1503,REP,1006,66.93280106,4375,6
Texas,TX,Crockett County,344,10,1219,1573,REP,875,55.62619199,3719,7
Texas,TX,Crosby County,527,30,1396,1953,REP,869,44.49564772,6059,2
Texas,TX,Culberson County,438,11,415,864,DEM,23,2.662037037,2398,9
Texas,TX,Dallam County,196,23,1386,1605,REP,1190,74.14330218,6703,7
Texas,TX,Dallas County,598576,15986,307076,921638,DEM,291500,31.62847018,2368139,1
Texas,TX,Dawson County,808,30,2951,3789,REP,2143,56.5584587,13833,7
Texas,TX,DeWitt County,1494,57,6567,8118,REP,5073,62.49076127,20097,6
Texas,TX,Deaf Smith County,1263,52,3293,4608,REP,2030,44.05381944,19372,6
Texas,TX,Delta County,403,27,2157,2587,REP,1754,67.80054117,5231,8
Texas,TX,Denton County,188695,6789,222480,417964,REP,33785,8.083232049,662614,1
Texas,TX,Dickens County,130,5,850,985,REP,720,73.0964467,2444,8
Texas,TX,Dimmit County,2264,18,1384,3666,DEM,880,24.00436443,9996,6
Texas,TX,Donley County,198,12,1438,1648,REP,1240,75.24271845,3677,8
Texas,TX,Duval County,2573,35,2442,5050,DEM,131,2.594059406,11782,7
Texas,TX,Eastland County,982,73,7216,8271,REP,6234,75.37178092,18583,6
Texas,TX,Ector County,11310,521,32586,44417,REP,21276,47.90057861,137130,3
Texas,TX,Edwards County,166,5,893,1064,REP,727,68.32706767,2002,9
Texas,TX,El Paso County,168801,4540,81235,254576,DEM,87566,34.39680096,800647,2
Texas,TX,Ellis County,27513,1402,56651,85566,REP,29138,34.05324545,149610,1
Texas,TX,Erath County,2914,254,13669,16837,REP,10755,63.87717527,37890,4
Texas,TX,Falls County,1899,57,4177,6133,REP,2278,37.14332301,17866,2
Texas,TX,Fannin County,2638,181,12150,14969,REP,9512,63.54465896,33915,6
Texas,TX,Fayette County,2650,111,10163,12924,REP,7513,58.13215723,24554,6
Texas,TX,Fisher County,352,26,1448,1826,REP,1096,60.02190581,3974,8
Texas,TX,Floyd County,437,17,1581,2035,REP,1144,56.21621622,6446,6
Texas,TX,Foard County,99,7,445,551,REP,346,62.79491833,1336,9
Texas,TX,Fort Bend County,195191,5047,157595,357833,DEM,37596,10.50657709,585375,1
Texas,TX,Franklin County,803,44,4153,5000,REP,3350,67,10605,7
Texas,TX,Freestone County,1629,83,6966,8678,REP,5337,61.5003457,19816,7
Texas,TX,Frio County,2421,31,2812,5264,REP,391,7.42781155,17217,6
Texas,TX,Gaines County,572,65,5323,5960,REP,4751,79.7147651,17526,7
Texas,TX,Galveston County,58247,2290,93306,153843,REP,35059,22.78881717,291309,1
Texas,TX,Garza County,231,9,1411,1651,REP,1180,71.47183525,6461,6
Texas,TX,Gillespie County,3163,159,12495,15817,REP,9332,58.99981033,24837,7
Texas,TX,Glasscock County,39,3,611,653,REP,572,87.5957121,1226,8
Texas,TX,Goliad County,872,25,3081,3978,REP,2209,55.5304173,7210,3
Texas,TX,Gonzales County,1894,72,5568,7534,REP,3674,48.76559596,19807,6
Texas,TX,Gray County,820,113,6812,7745,REP,5992,77.36604261,22535,6
Texas,TX,Grayson County,14223,761,43776,58760,REP,29553,50.29441797,120877,3
Texas,TX,Gregg County,14657,691,32352,47700,REP,17695,37.09643606,121730,3
Texas,TX,Grimes County,2831,148,9419,12398,REP,6588,53.13760284,26604,6
Texas,TX,Guadalupe County,28706,1253,47423,77382,REP,18717,24.18779561,131533,1
Texas,TX,Hale County,2271,127,7162,9560,REP,4891,51.16108787,36273,4
Texas,TX,Hall County,167,6,992,1165,REP,825,70.81545064,3353,9
Texas,TX,Hamilton County,641,93,3613,4347,REP,2972,68.36899011,8517,6
Texas,TX,Hansford County,166,32,1848,2046,REP,1682,82.20918866,5613,7
Texas,TX,Hardeman County,241,9,1330,1580,REP,1089,68.92405063,4139,9
Texas,TX,Hardin County,3449,300,23806,27555,REP,20357,73.87769915,54635,2
Texas,TX,Harris County,918193,21995,700630,1640818,DEM,217563,13.25942304,4092459,1
Texas,TX,Harrison County,7812,332,21318,29462,REP,13506,45.84210169,65631,4
Texas,TX,Hartley County,195,15,1866,2076,REP,1671,80.49132948,6062,7
Texas,TX,Haskell County,353,21,1837,2211,REP,1484,67.1189507,5899,6
Texas,TX,Hays County,59213,2182,47427,108822,DEM,11786,10.83053059,157107,1
Texas,TX,Hemphill County,206,28,1486,1720,REP,1280,74.41860465,3807,7
Texas,TX,Henderson County,7048,333,28816,36197,REP,21768,60.13758046,78532,4
Texas,TX,Hidalgo County,128199,2158,90527,220884,DEM,37672,17.05510585,774769,2
Texas,TX,Hill County,2829,145,11869,14843,REP,9040,60.90412989,35089,6
Texas,TX,Hockley County,1481,76,6534,8091,REP,5053,62.45210728,22935,6
Texas,TX,Hood County,5641,452,26487,32580,REP,20846,63.98403929,51182,1
Texas,TX,Hopkins County,3043,176,12713,15932,REP,9670,60.69545569,35161,6
Texas,TX,Houston County,2312,63,7050,9425,REP,4738,50.27055703,23732,7
Texas,TX,Howard County,2017,127,7899,10043,REP,5882,58.56815693,35012,4
Texas,TX,Hudspeth County,371,15,771,1157,REP,400,34.5721694,3476,2
Texas,TX,Hunt County,8879,503,29135,38517,REP,20256,52.58976556,86129,1
Texas,TX,Hutchinson County,957,125,7659,8741,REP,6702,76.67314953,22150,6
Texas,TX,Irion County,120,10,759,889,REP,639,71.87851519,1599,3
Texas,TX,Jack County,331,33,3415,3779,REP,3084,81.60889124,9044,6
Texas,TX,Jackson County,1018,76,5116,6210,REP,4098,65.99033816,14075,6
Texas,TX,Jasper County,2906,110,12453,15469,REP,9547,61.71698235,35710,6
Texas,TX,Jeff Davis County,501,20,783,1304,REP,282,21.62576687,2342,9
Texas,TX,Jefferson County,46022,1108,47535,94665,REP,1513,1.598267575,252273,2
Texas,TX,Jim Hogg County,1197,6,831,2034,DEM,366,17.99410029,5300,6
Texas,TX,Jim Wells County,6025,93,7389,13507,REP,1364,10.09846746,40838,4
Texas,TX,Johnson County,16418,987,54523,71928,REP,38105,52.9765877,150934,1
Texas,TX,Jones County,989,81,5621,6691,REP,4632,69.22732028,20202,3
Texas,TX,Karnes County,1220,50,3959,5229,REP,2739,52.38095238,14824,6
Texas,TX,Kaufman County,18290,671,37474,56435,REP,19184,33.99308939,103350,1
Texas,TX,Kendall County,6008,347,20064,26419,REP,14056,53.20413339,33410,1
Texas,TX,Kenedy County,65,2,127,194,REP,62,31.95876289,416,9
Texas,TX,Kent County,47,4,411,462,REP,364,78.78787879,808,9
Texas,TX,Kerr County,6510,370,20858,27738,REP,14348,51.72687288,49625,4
Texas,TX,Kimble County,284,21,1987,2292,REP,1703,74.30191972,4607,7
Texas,TX,King County,8,0,151,159,REP,143,89.93710692,286,9
Texas,TX,Kinney County,446,13,1144,1603,REP,698,43.54335621,3598,7
Texas,TX,Kleberg County,5359,125,5557,11041,REP,198,1.793315823,32061,4
Texas,TX,Knox County,265,11,1180,1456,REP,915,62.84340659,3719,9
Texas,TX,La Salle County,1052,19,1335,2406,REP,283,11.76226101,6886,6
Texas,TX,Lamar County,4420,220,16698,21338,REP,12278,57.54053801,49793,5
Texas,TX,Lamb County,835,46,3513,4394,REP,2678,60.94674556,13977,6
Texas,TX,Lampasas County,2134,169,8070,10373,REP,5936,57.22548925,19677,2
Texas,TX,Lavaca County,1333,60,8802,10195,REP,7469,73.26140265,19263,6
Texas,TX,Lee County,1745,82,6248,8075,REP,4503,55.76470588,16612,6
Texas,TX,Leon County,1072,78,7522,8672,REP,6450,74.37730627,16801,8
Texas,TX,Liberty County,5779,247,23288,29314,REP,17509,59.72913966,75643,1
Texas,TX,Limestone County,2213,93,6786,9092,REP,4573,50.29696436,23384,6
Texas,TX,Lipscomb County,131,17,1203,1351,REP,1072,79.34863064,3302,9
Texas,TX,Live Oak County,819,36,4198,5053,REP,3379,66.87116564,11531,8
Texas,TX,Llano County,3167,115,9996,13278,REP,6829,51.43093839,19301,7
Texas,TX,Loving County,4,2,60,66,REP,56,84.84848485,82,9
Texas,TX,Lubbock County,39757,1887,78560,120204,REP,38803,32.28095571,278831,2
Texas,TX,Lynn County,428,12,1853,2293,REP,1425,62.14566071,5915,2
Texas,TX,Madison County,1084,40,4165,5289,REP,3081,58.25297788,13664,6
Texas,TX,Marion County,1331,54,3459,4844,REP,2128,43.93063584,10546,8
Texas,TX,Martin County,288,15,1857,2160,REP,1569,72.63888889,4799,3
Texas,TX,Mason County,566,26,2108,2700,REP,1542,57.11111111,4012,9
Texas,TX,Matagorda County,3726,148,9836,13710,REP,6110,44.56601021,36702,4
Texas,TX,Maverick County,8324,133,6881,15338,DEM,1443,9.408006259,54258,5
Texas,TX,McCulloch County,490,42,2898,3430,REP,2408,70.20408163,8283,7
Texas,TX,McLennan County,36550,1635,59432,97617,REP,22882,23.44058924,234906,2
Texas,TX,McMullen County,53,3,460,516,REP,407,78.87596899,707,9
Texas,TX,Medina County,6731,238,15599,22568,REP,8868,39.29457639,46006,1
Texas,TX,Menard County,196,8,819,1023,REP,623,60.89931574,2242,9
Texas,TX,Midland County,12258,1031,45463,58752,REP,33205,56.51722495,136872,3
Texas,TX,Milam County,2475,98,7950,10523,REP,5475,52.0288891,24757,6
Texas,TX,Mills County,271,17,2214,2502,REP,1943,77.6578737,4936,9
Texas,TX,Mitchell County,397,12,2169,2578,REP,1772,68.73545384,9403,7
Texas,TX,Montague County,1097,102,8613,9812,REP,7516,76.60008153,19719,6
Texas,TX,Montgomery County,74255,3696,193224,271175,REP,118969,43.87166959,455746,1
Texas,TX,Moore County,1059,87,4356,5502,REP,3297,59.92366412,21904,7
Texas,TX,Morris County,1664,43,3841,5548,REP,2177,39.23936554,12934,6
Texas,TX,Motley County,46,2,604,652,REP,558,85.58282209,1210,9
Texas,TX,Nacogdoches County,8989,407,17359,26755,REP,8370,31.28387217,64524,5
Texas,TX,Navarro County,5097,221,13787,19105,REP,8690,45.48547501,47735,4
Texas,TX,Newton County,1175,39,4882,6096,REP,3707,60.81036745,14445,2
Texas,TX,Nolan County,1161,64,4127,5352,REP,2966,55.41853513,15216,6
Texas,TX,Nueces County,60749,1768,64467,126984,REP,3718,2.927927928,340223,2
Texas,TX,Ochiltree County,302,42,2811,3155,REP,2509,79.52456418,10223,7
Texas,TX,Oldham County,81,11,917,1009,REP,836,82.8543112,2052,2
Texas,TX,Orange County,6354,450,29170,35974,REP,22816,63.4235837,81837,2
Texas,TX,Palo Pinto County,2177,131,10170,12478,REP,7993,64.05673986,28111,6
Texas,TX,Panola County,2057,73,9322,11452,REP,7265,63.43870066,23796,6
Texas,TX,Parker County,12789,1061,61584,75434,REP,48795,64.6856855,116927,1
Texas,TX,Parmer County,488,27,2133,2648,REP,1645,62.1223565,10269,7
Texas,TX,Pecos County,1378,71,3213,4662,REP,1835,39.36078936,15507,7
Texas,TX,Polk County,5353,223,18496,24072,REP,13143,54.59870389,45413,6
Texas,TX,Potter County,9867,578,22732,33177,REP,12865,38.77686349,121073,2
Texas,TX,Presidio County,1463,33,721,2217,DEM,742,33.46865133,7818,7
Texas,TX,Rains County,841,56,5147,6044,REP,4306,71.24420913,10914,8
Texas,TX,Randall County,12750,1065,50597,64412,REP,37847,58.7576849,120725,2
Texas,TX,Reagan County,172,10,942,1124,REP,770,68.50533808,3367,6
Texas,TX,Real County,320,19,1643,1982,REP,1323,66.75075681,3309,9
Texas,TX,Red River County,1244,43,4513,5800,REP,3269,56.36206897,12860,6
Texas,TX,Reeves County,1394,40,2249,3683,REP,855,23.21477057,13783,7
Texas,TX,Refugio County,1108,48,2210,3366,REP,1102,32.73915627,7383,6
Texas,TX,Roberts County,17,4,529,550,REP,512,93.09090909,929,9
Texas,TX,Robertson County,2359,90,5631,8080,REP,3272,40.4950495,16622,3
Texas,TX,Rockwall County,18149,801,38842,57792,REP,20693,35.80599391,78337,1
Texas,TX,Runnels County,531,49,3682,4262,REP,3151,73.93242609,10501,6
Texas,TX,Rusk County,4624,232,16511,21367,REP,11887,55.63251743,53330,3
Texas,TX,Sabine County,662,32,4767,5461,REP,4105,75.1693829,10834,8
Texas,TX,San Augustine County,979,14,3005,3998,REP,2026,50.67533767,8865,9
Texas,TX,San Jacinto County,2332,142,10154,12628,REP,7822,61.94171682,26384,8
Texas,TX,San Patricio County,8971,384,16495,25850,REP,7524,29.10638298,64804,2
Texas,TX,San Saba County,287,7,2308,2602,REP,2021,77.67102229,6131,7
Texas,TX,Schleicher County,211,8,939,1158,REP,728,62.86701209,3461,8
Texas,TX,Scurry County,818,69,4978,5865,REP,4160,70.92924126,16921,7
Texas,TX,Shackelford County,130,14,1484,1628,REP,1354,83.16953317,3378,8
Texas,TX,Shelby County,2058,43,7962,10063,REP,5904,58.67037663,25448,7
Texas,TX,Sherman County,91,14,885,990,REP,794,80.2020202,3034,9
Texas,TX,Smith County,29343,1632,68546,99521,REP,39203,39.39168618,209714,3
Texas,TX,Somervell County,768,73,4099,4940,REP,3331,67.4291498,8490,1
Texas,TX,Starr County,9099,155,8224,17478,DEM,875,5.006293626,60968,4
Texas,TX,Stephens County,396,18,3385,3799,REP,2989,78.67859963,9630,7
Texas,TX,Sterling County,51,4,584,639,REP,533,83.41158059,1143,8
Texas,TX,Stonewall County,116,5,615,736,REP,499,67.79891304,1490,9
Texas,TX,Sutton County,322,13,1222,1557,REP,900,57.80346821,4128,7
Texas,TX,Swisher County,478,33,1842,2353,REP,1364,57.96855079,7854,6
Texas,TX,Tarrant County,411567,13389,409741,834697,DEM,1826,0.218762018,1809034,1
Texas,TX,Taylor County,14489,996,39439,54924,REP,24950,45.4264074,131506,3
Texas,TX,Terrell County,119,5,334,458,REP,215,46.94323144,984,9
Texas,TX,Terry County,757,42,2809,3608,REP,2052,56.87361419,12651,6
Texas,TX,Throckmorton County,82,11,806,899,REP,724,80.53392659,1641,9
Texas,TX,Titus County,2852,115,7563,10530,REP,4711,44.73884141,32334,7
Texas,TX,Tom Green County,12106,656,32129,44891,REP,20023,44.60359538,110224,3
Texas,TX,Travis County,435860,13152,161337,610349,DEM,274523,44.97803716,1024266,1
Texas,TX,Trinity County,1323,36,5579,6938,REP,4256,61.34332661,14585,7
Texas,TX,Tyler County,1390,62,8095,9547,REP,6705,70.23148633,21766,6
Texas,TX,Upshur County,2869,206,15775,18850,REP,12906,68.4668435,39309,3
Texas,TX,Upton County,169,20,1176,1365,REP,1007,73.77289377,3355,8
Texas,TX,Uvalde County,4066,97,6160,10323,REP,2094,20.28480093,26405,6
Texas,TX,Val Verde County,6401,177,7839,14417,REP,1438,9.974335854,48879,5
Texas,TX,Van Zandt County,3419,208,22126,25753,REP,18707,72.64008077,52579,6
Texas,TX,Victoria County,10371,487,23347,34205,REP,12976,37.93597427,86793,3
Texas,TX,Walker County,7875,398,15368,23641,REP,7493,31.69493676,67861,4
Texas,TX,Waller County,8130,281,14206,22617,REP,6076,26.86474776,43205,1
Texas,TX,Ward County,761,35,3238,4034,REP,2477,61.40307387,10658,6
Texas,TX,Washington County,4254,207,12949,17410,REP,8695,49.94256175,33718,6
Texas,TX,Webb County,41820,679,25898,68397,DEM,15922,23.27879878,250304,2
Texas,TX,Wharton County,4671,146,11892,16709,REP,7221,43.21623077,41280,4
Texas,TX,Wheeler County,168,10,2158,2336,REP,1990,85.18835616,5410,9
Texas,TX,Wichita County,13024,799,31930,45753,REP,18906,41.32188053,131500,3
Texas,TX,Wilbarger County,954,44,3520,4518,REP,2566,56.79504205,13535,6
Texas,TX,Willacy County,3097,41,2437,5575,DEM,660,11.83856502,22134,6
Texas,TX,Williamson County,142457,6590,138649,287696,DEM,3808,1.323619376,422679,1
Texas,TX,Wilson County,6350,199,18457,25006,REP,12107,48.41638007,42918,1
Texas,TX,Winkler County,358,15,1753,2126,REP,1395,65.61618062,7110,6
Texas,TX,Wise County,4953,358,26986,32297,REP,22033,68.21995851,59127,1
Texas,TX,Wood County,3487,216,18962,22665,REP,15475,68.2770792,41964,6
Texas,TX,Yoakum County,419,42,2172,2633,REP,1753,66.57804785,7879,7
Texas,TX,Young County,1036,94,7112,8242,REP,6076,73.71997088,18550,7
Texas,TX,Zapata County,1820,15,2032,3867,REP,212,5.48228601,14018,6
Texas,TX,Zavala County,2864,25,1490,4379,DEM,1374,31.37702672,11677,7
Wisconsin,WI,Adams County,4329,127,7362,11818,REP,3033,25.66424099,20875,8
Wisconsin,WI,Ashland County,4801,115,3841,8757,DEM,960,10.96265844,16157,7
Wisconsin,WI,Barron County,9194,349,15803,25346,REP,6609,26.07512033,45870,6
Wisconsin,WI,Bayfield County,6147,116,4617,10880,DEM,1530,14.0625,15014,8
Wisconsin,WI,Brown County,65511,2635,75871,144017,REP,10360,7.193595201,248007,2
Wisconsin,WI,Buffalo County,2860,122,4834,7816,REP,1974,25.25588536,13587,8
Wisconsin,WI,Burnett County,3569,110,6462,10141,REP,2893,28.5277586,15457,8
Wisconsin,WI,Calumet County,12116,502,18156,30774,REP,6040,19.62695782,48971,3
Wisconsin,WI,Chippewa County,13983,638,21317,35938,REP,7334,20.40736825,62415,3
Wisconsin,WI,Clark County,4524,372,10002,14898,REP,5478,36.77003625,34690,6
Wisconsin,WI,Columbia County,16410,532,16927,33869,REP,517,1.526469633,56833,2
Wisconsin,WI,Crawford County,3953,122,4620,8695,REP,667,7.671075331,16644,7
Wisconsin,WI,Dane County,260185,5806,78800,344791,DEM,181385,52.60723163,488073,2
Wisconsin,WI,Dodge County,16356,725,31355,48436,REP,14999,30.96663639,88759,4
Wisconsin,WI,Door County,10044,321,9752,20117,DEM,292,1.451508674,27785,6
Wisconsin,WI,Douglas County,13218,536,10923,24677,DEM,2295,9.300158042,44159,2
Wisconsin,WI,Dunn County,9897,454,13173,23524,REP,3276,13.92620303,43857,6
Wisconsin,WI,Eau Claire County,31620,1314,25341,58275,DEM,6279,10.77477477,98736,3
Wisconsin,WI,Florence County,781,26,2133,2940,REP,1352,45.98639456,4423,9
Wisconsin,WI,Fond du Lac County,20588,909,35754,57251,REP,15166,26.49036698,101633,3
Wisconsin,WI,Forest County,1721,47,3285,5053,REP,1564,30.95190976,9304,9
Wisconsin,WI,Grant County,10998,468,14142,25608,REP,3144,12.27741331,51208,6
Wisconsin,WI,Green County,10851,386,10169,21406,DEM,682,3.18602261,36842,2
Wisconsin,WI,Green Lake County,3344,159,7168,10671,REP,3824,35.83544185,19051,6
Wisconsin,WI,Iowa County,7828,255,5909,13992,DEM,1919,13.71497999,23687,2
Wisconsin,WI,Iron County,1533,39,2438,4010,REP,905,22.56857855,5916,9
Wisconsin,WI,Jackson County,4256,137,5791,10184,REP,1535,15.072663,20449,6
Wisconsin,WI,Jefferson County,19904,867,27208,47979,REP,7304,15.22332687,83686,4
Wisconsin,WI,Juneau County,4746,214,8749,13709,REP,4003,29.19979575,26664,7
Wisconsin,WI,Kenosha County,42193,1573,44972,88738,REP,2779,3.131691046,166426,1
Wisconsin,WI,Kewaunee County,3976,192,7927,12095,REP,3951,32.66639107,20574,2
Wisconsin,WI,La Crosse County,37846,1354,28684,67884,DEM,9162,13.49655294,114638,3
Wisconsin,WI,Lafayette County,3647,87,4821,8555,REP,1174,13.72296902,16836,8
Wisconsin,WI,Langlade County,3704,131,7330,11165,REP,3626,32.47648903,19977,6
Wisconsin,WI,Lincoln County,6261,219,10017,16497,REP,3756,22.76777596,28743,6
Wisconsin,WI,Manitowoc County,16818,793,27218,44829,REP,10400,23.19926833,81442,4
Wisconsin,WI,Marathon County,30808,1319,44624,76751,REP,13816,18.00106839,134063,3
Wisconsin,WI,Marinette County,7366,309,15304,22979,REP,7938,34.54458419,41749,6
Wisconsin,WI,Marquette County,3239,107,5719,9065,REP,2480,27.35797022,15404,8
Wisconsin,WI,Menominee County,1303,9,278,1590,DEM,1025,64.46540881,4232,8
Wisconsin,WI,Milwaukee County,317270,7344,134357,458971,DEM,182913,39.85284473,947735,1
Wisconsin,WI,Monroe County,8433,403,13775,22611,REP,5342,23.62566892,44673,6
Wisconsin,WI,Oconto County,6715,274,16226,23215,REP,9511,40.96920095,37660,2
Wisconsin,WI,Oneida County,10105,383,13671,24159,REP,3566,14.76054472,35998,7
Wisconsin,WI,Outagamie County,47667,1970,58385,108022,REP,10718,9.922052915,176695,3
Wisconsin,WI,Ozaukee County,26517,1057,33912,61486,REP,7395,12.02712813,86395,1
Wisconsin,WI,Pepin County,1489,71,2584,4144,REP,1095,26.42374517,7469,8
Wisconsin,WI,Pierce County,9839,716,12903,23458,REP,3064,13.06164208,41019,1
Wisconsin,WI,Polk County,9370,390,16611,26371,REP,7241,27.45819271,44205,6
Wisconsin,WI,Portage County,20428,876,19299,40603,DEM,1129,2.780582716,70019,4
Wisconsin,WI,Price County,3032,120,5394,8546,REP,2362,27.63866136,14159,9
Wisconsin,WI,Racine County,50159,1813,54479,106451,REP,4320,4.058205184,195408,3
Wisconsin,WI,Richland County,3995,148,4871,9014,REP,876,9.718216108,18021,6
Wisconsin,WI,Rock County,46658,1564,37138,85360,DEM,9520,11.15276476,160331,3
Wisconsin,WI,Rusk County,2517,112,5257,7886,REP,2740,34.74511793,14755,6
Wisconsin,WI,Sauk County,18108,602,17493,36203,DEM,615,1.698754247,61976,4
Wisconsin,WI,Sawyer County,4498,103,5909,10510,REP,1411,13.42530923,16557,7
Wisconsin,WI,Shawano County,7131,303,15173,22607,REP,8042,35.57305259,41949,6
Wisconsin,WI,Sheboygan County,27101,1293,37609,66003,REP,10508,15.92048846,115507,3
Wisconsin,WI,St. Croix County,23190,1318,32199,56707,REP,9009,15.88692754,84345,1
Wisconsin,WI,Taylor County,2693,336,7655,10684,REP,4962,46.44327967,20689,6
Wisconsin,WI,Trempealeau County,6285,102,8833,15220,REP,2548,16.74113009,28816,6
Wisconsin,WI,Vernon County,7457,239,8218,15914,REP,761,4.781952997,29773,6
Wisconsin,WI,Vilas County,5903,205,9261,15369,REP,3358,21.84917691,21430,9
Wisconsin,WI,Walworth County,22789,960,33851,57600,REP,11062,19.20486111,102228,4
Wisconsin,WI,Washburn County,3867,177,6334,10378,REP,2467,23.77143958,15911,7
Wisconsin,WI,Washington County,26650,1183,60237,88070,REP,33587,38.13670944,131887,1
Wisconsin,WI,Waukesha County,103906,4441,159649,267996,REP,55743,20.79993731,389891,1
Wisconsin,WI,Waupaca County,9703,475,18952,29130,REP,9249,31.7507724,52410,6
Wisconsin,WI,Waushara County,4388,164,9016,13568,REP,4628,34.10966981,24496,6
Wisconsin,WI,Winnebago County,44060,2304,47796,94160,REP,3736,3.967714528,166994,3
Wisconsin,WI,Wood County,16365,625,24308,41298,REP,7943,19.23337692,74749,4
